A Bad Haircut - The perfect start to a bad hair day.
A Bull Fight - Also known as "la fiesta brava" (the brave festival). A whole lot of bull..
A Car Crash - "Hey, it was an accident!"
A Cheap Motel - No charge for the cockroaches.
A Crawl Space - Where you'll find something the cat dragged in.
A Dozen Red Roses - When eleven just won't do.
A Flat Tire - "Whaddya mean, there's no spare?"
A Full Moon - "When the moon hits your eye like a big pizza pie, that's amore!" -Dean Martin
A Haunted House - Maybe if people would STOP building their dream homes on ancient burial grounds ...
A High School Bathroom - "Fools rush in where angels fear to tread" -Alexander Pope
A Honeymoon - America's top honeymoon spots are Hawaii, Niagara Falls, Las Vegas and Florida. You can get there by air, land, sea ... or shotgun.
A Locker Room - Steamy atmosphere ... bawdy humor ... sweaty bodies ... HEY! Sounds like Cable TV!
A Morgue - "Given strange eons, even death may die..." -H.P. Lovecraft
A Nine Iron - A golf club best used on short shots or large opponents.
A School Bus - The only thing we have to fear is fear itself. -Franklin D. Roosevelt
A School Cafeteria - Food fight!.
A Sunrise - "But he who kisses the joy as it flies/ Lives in eternity's sunrise." -William Blake
A Sunset - The sun never set on the British Empire ... because God didn't trust the English in the dark.
A Tree House - Your first high-rise apartment.
A Used Car Lot - One of the most honest places around. Honest ...
Abraham Lincoln - 1809-65, 16th U.S. president, led the Union to victory in the American Civil War and abolished slavery. Was assassinated for his efforts.
Adam Sandler - 1966- , American comedian, film star, and Saturday Night Live alumnus. Genius or goofball - you make the call.
Adolph Hitler - 1889-1945, turned Germany into a militarized dictatorship, caused the slaughter of millions and launched World War II.
AIDS - Acquired Immune Deficiency Syndrome.
Airline Food - Since when is a bag of peanuts considered a meal?
Al Pacino - 1940- , Oscar winning American actor and star of "The Godfather," "Dog Day Afternoon" and "Scent Of A Woman." One very intense guy.
Albert Einstein - 1879-1955, German-born American physicist and Nobel laureate who created theories of relativity. Nice hair.
Alfred Hitchcock - 1899-1980, British-born American director and producer of brilliant psychological thrillers. Right, mother? MOTHER!
Alien Abductions - There was a blinding light -and she was gone!
Americans - How many Americans does it take to screw in a light bulb? THAT'S NOT FUNNY! WE'RE SUING!
Amputations - "A SCRATCH? Your arm's off!" - Monty Python and the Holy Grail.
Angry Hornets - Who put the bees in their bonnets?.
Andy Warhol - 1928-87, American painter and filmmaker, a leader of the pop art movement. Famous for slightly more than 15 minutes.
Anne Frank - 1929-45, German Jewish girl who wrote in her diary about her family hiding from the Nazis. She died in a concentration camp.
Antarctica - Home to the lowest temperature ever recorded on earth, -126.9 F.
Anthony Hopkins - 1937- , British actor starred in The Elephant Man, Howard's End, and, of course, The Silence Of The Lambs. Knighted in 1992.
Apple Pie - It's as American as ... as ... something ...
Apples - More than 40 million metric tons are produced worldwide every year. How 'bout them apples?
Armed Robbery - You got your Robbery, your Armed Robbery, your Strong Armed Robbery, and, of course, the five finger discount.
Assembly Lines - Faster. FASTER!
At My Parent's House - Like never-never land, you're never seen as an adult here.
Atlantis - Mythological city where the folks had that sinking feeling.
Atomic Bombs - The Italian physicist Enrico Fermi succeeded in producing the first nuclear chain reaction in 1942, at the University of Chicago.
Attack On Pearl Harbor - "Yesterday, December 7th, 1941, a date which will live in infamy ..." -Franklin D. Roosevelt
Austin Powers - Fictional British man of mystery. Yeah, bay-beee, yeah!
Australian Outback - Beware of dangerous temperatures, strange animals, and didgeridoos.
Babe Ruth - 1895-1948, American baseball legend, and one heck of a candy bar!
Babies - Little bundles of joy ... and who needs sleep, anyway?
Baby Showers - Baby showers may bring flowers ...
Backstreet Boys - The latest American pop boy band. Which one do you think is the cutest?
Bad Dogs - Bad dog, bad dog. What'cha gonna do?
Bagpipes - A shrill-toned musical instrument consisting of a leather bag and pipes. Also available in plaid.
Baked Beans - Add a little bacon, brown sugar and Beano!
Baked Potatoes - Hot potato, couch potato, potato head, twice baked, half-baked, ... whatever.
Baking Cookies - An experience only surpassed by eating them.
Bald Eagles - Known for their majestic appearance and powerful flight. In 1782, the bald eagle was chosen as the emblem of the United States.
Ballerinas - Beautiful, graceful dancers who are always on their toes.
Bangkok - Capital of Thailand. Location: near the Gulf of Siam. Population: five million. Reputation: seedy.
Bankruptcy - It'll be the debt of you.
Barbara Walters - 1931- , American television journalist and author. Voted one of the most important women of the century by "Ladies Home Journal."
Barbed Wire - Wire with sharp points, used for fences. Created havoc on the western frontier.
Barfing - We didn't want to bring that up ...
Barney - Purple dinosaur. "I love you, you love me, blah, blah, blah ... "
Bart Simpson - Fictional animated character. Don't have a cow, man!"
Bates Motel - The haunt of Alfred Hitchcock's psycho, Norman Bates ... and mother, of course ...
Batman - How does Batman's mother call him home? "Dinner, dinner, dinner, dinner, dinner, dinner, dinner, dinner - BATMAN!"
Bats - The little brown bat consumes as many as 600 mosquitoes in an hour. The vampire bat dines elsewhere ...
Beach Parties - Up for some "Beach Blanket Bingo," Annette?
Beanie Babies - Tiny plush collectibles to love and cherish. Don't take that tag off!
Beauty And The Beast - A tale as old as time ... so Disney didn't have to pay royalties.
Beer - "Beer is proof that God loves us and wants us to be happy." - Benjamin Franklin
Beer Bellies - Just think of them as microbreweries.
Beethoven - 1770-1827, German composer, considered one of the greatest of the western world.
Beets - Beats Brussels sprout.
Being In Love - "Love's like the measles, all the worse when it comes late." -Douglas Jerrold
Bell-Bottoms - Bell-bottoms and pea coats -who would have thought the Navy could be such a trendsetter?
Ben Stiller - 1965-, American actor, director, and funny guy of Reality Bites, There's Something About Mary, and Meet The Parents
Berlin - 1945 - Adolph Hitler's last stand. Bunker ... I mean -hunker down, soldier.
Big Bang Theory - A cosmological theory for the origin of the universe. An explosive idea!
Big Macs - T w o a l l b e e f p a t t i e s s p e c i a l s a u c e l e t t u c e c h e e s e p i c k l e s o n i o n s o n a s e s a m e s e e d b u n .
Bigfoot - Legendary North American monster, a.k.a. Sasquatch or the Abominable Snowman.
Bill Clinton - 1946- , popular, yet embattled, 42nd president of the United States.
Bill Gates - 1955-, chairman and chief software architect of Microsoft Corporation. A very rich guy.
Bill Murray - 1950-, American actor and comedian. Star of Ghostbusters, Stripes, Groundhog Day, and Lost In Translation.
Billboards - Only 1,254 miles to Wall Drug ...
Bingo - "There was a farmer, had a dog, and Bingo was his name-o ..."
Bird Watching - A hobby that relies on a wing and a prayer.
Black Holes - The gravitational field of a black hole is so strong that nothing, including light, can escape from its vicinity.
Black Velvet - Smooth, silky and sophisticated ... until you paint an Elvis on it.
Blizzard - Extreme cold, strong winds, and a head snowfall. Also known as Canada.
Blood - A healthy human body contains between five and six quarts of blood. Bloody right they do!
Board Games - Games have been played for thousands of years. Some games of Monopoly just SEEM that long.
Body Odor - Over $1.6 billion is spent each year on antiperspirants in the United States. That stinks!
Body Piercing - YOU STUCK WHAT? WHERE?
Body Surfing - When you're too cheap to buy a surfboard.
Bonbons - Sweets for the sweet ...
Bongos - Small drums played with the fingers. Used in Latin American and African music. The choice of American beat poets.
Bottled Water - How much are you willing to pay for something you can get for free?
Boxing - An ancient and honorable sport - not just for boys anymore ...
Boy Scouts - International organization for boys and young men founded in England in 1908, to foster character, citizenship and outdoor life.
Boyfriends - "My boyfriend's back and you're gonna be in trouble." - The Angels
Brad Pitt - 1963- , American actor and heart-throb.
Brain Surgeons - Hey, it ain't brain surgery ... oh ... wait a second ...
Brains - Vital to human existence and mad scientists.
Britney Spears - 1981-, American singer. From mouseketeer to international pop star.
Broadway - The New York theater district. "They say the neon lights shine bright on Broadway." -Barry Mann
Bruce Willis - 1955- , Diehard American action movie star who has moonlighted on TV. He also starred in Pulp Fiction, Armageddon and The Sixth Sense.
Bubble Gum - Crack it, snap it, pop it, and blow it!
Bubbles - "Tiny bubbles, in the wine/ Tiny bubble make me feel fine ..." -Don Ho
Bullwinkle - As in the cartoon "The Adventures of Rocky and Bullwinkle" - the moose half of moose and squirrel.
Bumper Stickers - Your personal billboard!
Bungee Jumping - Another sport hanging on by a thread.
Buying A House - If only we had the money, we could get a mortgage.
Cabbage - From the French word caboche, meaning "big head."
Cactus - Require little care and exhibit bizarre forms. As such, they are often mistaken for Survivalists.
California - Sacramento is its capital, Los Angeles its largest city. Here we come.
Camping Trip - When you just have to get s'more nature.
Canada - Federated country of North America. The Great White North - eh?
Canadians - How many Canadians does it take to screw in a lightbulb? Fifteen. Fourteen to chip it out of the ice, and one to screw it in.
Captain Kirk - Fictional starship captain. "Beam me up Scotty, there is no intelligent life on this planet!" - bumper sticker, 1980s
Car Bombs - Not including the Ford Pinto, of course.
Car Horns - Blow it, buddy!
Carl Sagan - 1934-96, American astronomer and pioneer exobiologist. Touched many lives. Billions and billions of them.
Carnival Workers - Step right up ...
Cary Grant - 1904-86, British-born American actor known for his debonair manner. He can be found North by Northwest.
Casablanca - The largest city in Morocco, and one heck of a good movie. "Of all the gin joints in all the towns in all the world..."
Casinos - Slots and slots of fun.
Castles - Kings, queens, knights in shining armor, and little square hamburgers.
Caves - Stalactites, stalagmites. Which go up and which go down?
Celine Dion - 1968-, Canadian singer whose heart will go on, and on ...
Cell Phones - Get off the phone or get off the road!
Cesar Chavez - 1927-93, American labor leader who led the 1965 nationwide boycott of California grapes ... a bunch of sour grapes!
Chain Letters - Send this game to ten of your friends and good luck will follow. Honest!
Chains - Gold or iron: name your shackles.
Challenger Explosion - "Without a wish, without a will/ I stood upon that silent hill/ and stared into the sky ..." - Ralph Hodgeson
Chameleons - The chameleon is a lizard that changes color when frightened -or is that a politician?
Charging Rhinos - How do you stop a rhino from charging? Take away its credit cards.
Cheesecake - A really tasty dish.
Cher - 1946- , American singer and actor, she makes aging look good.
Chicago - Third largest city in the United States. Our kind of town.
Chicken Pox - Infectious disease usually contracted in childhood. Just don't scratch 'em!
Chickens - From incubator to rotisserie in 56 days! Run, chicken, run!
Chimpanzees - Sure, they're related to us; but they don't write, and they NEVER call!
China - The most populous country in the world. More than one-fifth of the world's total population lives within its borders.
Chinatown - International travel, just around the corner.
Choir Boys - They sound angelic, but ...
Chorus Girls - Long legs and high kicks!
Cigarette Burns - Another reason to give up smoking.
Cigarettes - Mind if I smoke?
Cinco de Mayo - Marks the victory of the Mexican Army over the French at the Battle of Puebla, in 1862.
Cindy Crawford - 1966- , American Supermodel. What dreams are made of.
Clark Gable - 1901-60, American film actor, noted as a romantic lead. Frankly, my dear, he didn't give a damn.
Claude Monet - 1840-1926, French painter, regarded as one of the leaders on the impressionist movement.
Cleaning The Bathroom - It's YOUR turn!
Cleopatra - c. 69-30 BC, Queen of Egypt, noted for love affairs with Julius Caesar and Mark Antony, which came back to bite her in the asp.
Clint Eastwood - 1930-, American film actor and director, past mayor of Carmel, California. Has earned fistfuls of dollars.
Clowns - They would be really funny if they weren't so darn scary.
Cocaine - Alkaloid obtained from leaves of the coca plant and used as a local anesthetic and abused as a drug.
Cockroaches - Annoying insects that can survive a nuclear war. Fortunately, they can't survive the heel of your shoe.
Coconuts - "Put the lime in the coconut, and drank them both up." -Harry Nillson
Cold Pizza - The breakfast of champions.
Communists - "From each, according to their ability, to each according to their need." I need a new Ferrari.
Commuting - The daily grind. And we're not talking coffee.
Computer Hackers - We didn't mean to shut down the entire government ...
Computers - British mathematician Charles Babbage worked out the principles of the modern digital computer in the late 1800s.
Confucius - c. 551-479 BC, K'ung Fu-Tzu, Chinese philosopher and one of the most influential figures in Chinese history.
Conspiracy Theories - Oh, that was just a coincidence!
Construction Workers - Hard hats -hard bodies.
Corn On The Cob - A grain native to the Americas, corn was a staple food for many centuries before corn holders were invented.
Corvettes - In 1953, Chevrolet introduced the Corverre, the first mass-produced sports car with a fiberglass body. The perfect cure for a midlife crisis.
Count Dracula - "I vant to suck your blood!"
Country Music - Encompassing styles such as western swing, honky-tonk, bluegrass and rockabilly. Should mention a pickup truck and a dog named "Bo."
Cow-Pies - When dried, these "cow chips" are hurled discus-like over great distances. It's true.
Crazy Horse - 1849?-77, chief of the Oglala Sioux. A leader in the Native American resistance to the westward expansion on the United States.
Creamed Corn - Eat it, it's good for you.
Crystal Balls - I see a Green Apple card in your future.
Cuba - Island republic in the Caribbean, just south of Florida. Beans and rice never tasted so good.
Cults - They seemed nice ...
Custer's Last Stand - 1866, Little Big Horn. Very big mistake.
Dandruff - Dry skin on your scalp? Sounds a bit flaky.
Danielle Steel - 1947- , Prolific romance novelist. "Suddenly, Stephanie spotted Lance on the beach ..."
Danny DeVito - 1944- , American television, motion-picture actor, and director. Star of Taxi, Romancing The Stone, Twins, and Get Shorty.
Dark Alleys - Don't go there!
Darth Vader - "Luke ... (wheeze) .. I am ... (wheeze) ... your father ... and you don't write, you don't call ... NOTHING."
Dating - First stage of the human mating ritual.
David Letterman - 1947- , American television entertainer and talk-show host. And ... the Number One reason to watch him (drum roll, please): TOP TEN LISTS!
Daytime TV - Soap operas, game shows, talk shows and reruns ... is this a great country or what?
Death Valley - Arid, desolate and hellish region of California. Named by a survivor of an attempted 1849 crossing.
Deer Hunting - Nooo! Nooooo! Not BAMBI'S MOTHER!
Demi Moore - 1962-, American actor in St. Elmo's Fire, Ghost and GI Jane.
Democrats - Their symbol is the donkey, or ass. Insert your own joke here.
Denzel Washington - 1954- , American actor known for his powerful roles in such movies as Cry Freedom, Malcolm X, and Mississippi Masala.
Detroit - The Motor City is the world's foremost automobile manufacturing center, and the tenth largest city in the U.S.
Diamonds - The hard fact: they are just highly refractive crystalline allotropes.
Discos - Where you go to catch "Saturday Night Fever."
Discovering America - 1492, Christopher Columbus discovered that America was discovered centuries before he arrived.
Disneyland - You've just won the "Apples to Apples(R) Grand Masters Tournament." Where're you gonna go?
Divorce - It's a trial separation that goes to trial.
Doctors - Over twenty years of education and they're still "practicing" medicine?
Doing The Dishes - You wash, I'll watch.
Dolly Parton - 1967- , American singer, songwriter, and actor. Known as much for her personal style as for her successful career.
Dr. Kevorkin - 1928- , Controversial advocate of doctor-assisted suicide.
Dr. Seuss - 1904-1991, Theodor Suess Geisel , the cat who came up with "The Cat in the Hat."
Driving Off A Cliff - It was either that or hire someone to do my takes.
Duct Tape - All-purpose, ... all the time ...
E-Mail - You've got JUNK mail!
Ear Wax - A waxy, yellowish substance that protects the ear from dust, bacteria, and from hearing things you don't want to hear.
Earthquakes - The Richter scale is named after the American seismologist Charles Richter. Did the earth move for you?
Earwigs - Nocturnal insects with abdominal pincers. Nothing to do with ears or wigs.
East Coast - From New England to Florida. They're not like folks 'round here ...
Eddie Murphy - 1961-, American comedian, actor, and producer. Best known for his work in 48 Hours, Beverly Hills Cop and on Saturday Night Live.
Eleanor Roosevelt - 1884-1962, first lady, social activist, author, lecturer, and U.S. representative to the United Nations.
Electric Eels - Slippery and slimy snakelike fishes that emit electrical charges. The shocking truth!
Electricity - The repulsive or attractive force between two stationary bodies. No problem unless one of those bodies is yours.
Elephants - The largest living land mammal, with two species: Indian and African. Not counting Dumbo, there are no American elephants.
Elizabeth Taylor - 1932- , American actor, noted for her lush beauty, emotional performances and multiple husbands.
Elvis Presley - 1935-77, American singer and actor and the king of rock-and-roll. His death left the music world all shook up.
Emily Dickinson - 1830-86, American poet, whose lyrics are psychologically astute treatments of love, death, and immortality. So there.
Ernest Hemingway - 1899-1961, American novelist and short-story writer, whose macho style is crisp, laconic and understated.
Europe - The Old Country ... except to people who live there.
Exorcism - To ceremoniously expel an evil spirit.
Eyes - Light-sensitive organ of vision in animals. See?
Falling Down - "What we call failure is not the falling down, but the staying down." -Mary Pickford
Family Reunions - Just to remind you why you moved away in the first place ...
Family Vacations - Dad? Dad? Are we there yet? Are we there yet? Are we? Huh? Dad?
Family Values - Often said but seldom understood.
Fast Food - You want fries with that?
Feathers - Which weighs more, a pound of feathers or a pound of rocks?
Feminists - Political and social activists who support selected women's causes.
Festering Wounds - Quit picking at that!
Fidel Castro - 1927-, Cuban revolutionary and Communist dictator since 1976. He earned a PhD in law in 1950.
Firefighters - Emperor Augustus instituted a corps of fire-fighting "watchmen" in 24 B.C. Nero, on the other hand, fiddled while Rome burned.
Firestorms - Some severe wildfires require more than 10,000 firefighters. And, wouldn't ya know it, some idiot parked in front of the hydrant!
Fireworks - Includes firecrackers, Roman candles, and bottle rockets. It's all fun until someone loses an eye ... and a nose ... and an arm ...
First Man On The Moon - July 20, 1969. "That's one small step for a man, one giant leap for mankind." -Neil A. Armstrong
Flipper - American television dolphin of the 1960's ... like Lassie, only wetter.
Fly Fishing - ... if you can"t catch flies any OTHER way ...
Flying Monkeys - The reason why "The Wizard Of Oz" still gives us nightmares.
Forest Fires - "Only YOU can prevent forest fires." The heat is on!
Fort Knox - American military post in Kentucky, containing the greater part of the gold reserve of the U.S. government.
Fourth Of July - "Independence Day" in the United States. "Thank Goodness We Got Rid of Them Day" in Britain.
Frank Lloyd Wright - 1867-1959, pioneering American architect. Considered one of the greatest designers of the 20th century.
Frank Sinatra - 1915-98, the greatest American pop singer of his generation, award winning film and television actor. Do-be do-be do, baby.
Freckles - No matter what they tell you, freckles won't grow together to form a great-looking tan.
Freedom - Express yourself!
French Wines - The perfect complement to an overpriced meal.
Fresh Water Pearls - String them along ...
Friction - Resistance to the motion of a body in contact with another body ... any body will do.
Fund Raising - Hello ... my name is Jonathan, would you like to buy some fruit, magazines, candy bars, wreaths, pizzas ... ?
Funerals - "He who dies with the most toys is, nonetheless, still dead." - Anonymous
Fur - The characteristic covering of mammals and people with money.
Fuzz - Lint ... Policemen ... Whatever ...
Gall Bladder - Where excess bile is stored. Stored for what, we don't know.
Gang Members - "When you're a Jet, you're a Jet all the way..." -West Side Story
Garrison Keillor - 1942- , American author and radio star. He shares the Midwest perspective with 2.6 million listeners each week on A Prairie Home Companion.
Garth Brooks - 1962- , American country music singer and songwriter. He's got friends in low places.
Geishas - Japanese women training in traditional singing, dancing, and entertaining. Of course, you would never recognize them without all that make-up.
Gen. George S. Patton - 1885-1945, the commander of the American Third Army during World War II. -a.k.a. Olf Blood and Guts
Genetic Engineering - What DO you get when you cross a monkey with a potato?
George W. Bush - 1946- , 43rd president of the United States. The second time ever that the son of a former president was elected to the office.
George Washington - 1732-99, First President of the United States. He chopped down a cherry tree to make false teeth, or something like that ...
Georgia O'Keeffe - 1887-1986, American abstract painter known for her still life compositions. Her skull paintings prove that beauty is more than skin deep.
Getting A Hug - Hmmmm ... nice.
Ghost Towns - Population unknown.
Ghosts - Nonmaterial embodiments or the essence of organisms (mostly human beings). Quite spirited
Giant Squid - Going fishing for giant squid? Nautilus I have to ...
Gila Monsters - The largest, and only poisonous lizard found in the United States.
Gingko Trees - An Asiatic tree, Gingko biloba, known for its fan shaped leaves. We can't remember what it's good for.
Ginseng - Common name for plants of the ginseng family, source of a stimulant and a supposed aphrodisiac.
Girl Scouts - I'll take six boxes of Thin Mints and three of the ... you know, the kind with the peanut butter.
Girlfriends - Girlfriend - let's talk!
Giving A Hug - "One may give without loving; but none can love without giving." -Anonymous
Glaciers - It'll be a cold day when we see THEM again ...
Glazed Donuts - If you're going to be late, take a box of donuts.
Global Warming - Is it hot in here, or is it just me?
Going To Church - Weddings, funerals, bazaars, and bingo!
Going To Grandma's - "Grandmother, what big teeth you have!" -Little Red Riding Hood
Going To School - Secondary education? It's elementary.
Going To The Dentist - This won't hurt a bit ...
Going To The Gym - No pain, no gain.
Gold Chains - The more, the better.
Goldfish - The pet, the carnival prize, or the snack cracker.
Golf-Ball-Sized Hail - ... which is almost as impressive as hail-sized golf balls ...
Grace Kelly - 1929-82, Princess of Monaco and American film star of Dial M for Murder, Rear Window, and To Catch a Thief. Always chic, always elegant.
Graffiti - Art in a can. We"re drawn to it.
Grass Skirts - Hula loves you, baby?
Grave Robbers - Famous for their bodies of work.
Gravity - In 1684, the law of gravitation was formulated by English physicist Sir Isaac Newton, who recognized the gravity of the situation.
Greenpeace - International organization dedicated to preserving the Earth's natural resources, and its diverse plant and animal life.
Gym Teachers - "I am a Physical Education Teacher. Call me a gym teacher again and you can drop and give me ten!"
Hair Transplants - Oh, it looks so natural ...
Hairballs - Cough it up, kitty ...
Halloween - October 31, the eve of All Saints' Day, celebrated with costumes, treats, and scary stuff. Not just for kids any more!
Hand Grenades - Close only counts in horseshoes and hand grenades!
Handcuffs - "You have the right to remain silent..."
Handguns - Source of a never-ending controversy as to how to get them out of the hands of the bad guys and into the hands of the good guys.
Hangnails - We've fingered the cause of the pain.
Having A Baby - "Rock-a-bye baby, on the tree top ..." Who would put a kid on a tree top?
Having An Operation - What a cutup! A real stitch.
Hawaii - The eight islands that make up America's 50th state entered the Union on August 21, 1959.
Helen Keller - 1880-1968, American author and lecturer who overcame deafness and blindness with the help of her companion, Anne Sullivan.
Hiccups - How do you, hic, get em? How do you, hic, get rid of "em?
High School Football - The whole ten yards!
High School Reunions - See also: "root canal, as fun as ..."
Hillary Rodham Clinton - 1947- , New York Senator, lawyer, and former American First Lady.
Hiroshima - 1945 - "I am become death, the destroyer of worlds" - J. Robert Oppenheimer, on the detonation of the first atmoic bomb.
HMOs - Heath Maintenance Organizations. Here's to your health ...
Hockey - Did you hear about the big fight last night? All of a sudden, a hockey game broke out!
Hollywood - Motion picture and television industry center of the world. Hooray for Hollywood!
Homeless Shelters - In the United States, nearly three-quarters of the help for the homeless comes from the private sector, mostly from church soup kitchens.
Homer Simpson - Fictional cartoon character created by Matt Groening. D'oh!
Homework - Something to do during comercials.
Hooligans - "Hey! Kids! Get outta my yard!"
Horseback Riding - WHOAAA!!!
Hot Lava - There's no better way to serve it.
House Guests - How many visitors does it take to drive you crazy? Go on -take a guest!
Hummingbirds - Why do hummingbirds hum? Because they don't know the words ... ... da-dum, dum!
Humphrey Bogart - 1899-1957, American film actor, starred in such classics as The Maltese Falcon and Casablanca. "Here's looking at you kid."
Icebergs - May reach 300 to 500 feet above the oceans's surface. Ask the captain of the Titanic about the 90 percent that's UNDER water.
In A Coma - A deep, prolonged state of unconsciousness ... sometimes you just feel that way.
Incense - Incense is better than no sense at all.
India - The world's seventh largest country by area, but the second most populous, with one billion people.
Indiana Jones - Fictional archeologist and action hero. Proof that a good hat and a whip can take you a long way.
Industrial Revolution - The first Industrial Revolution occurred in Great Britain at the end of the 1700s. The second came with the invention of the "Clapper."
Infomercials - One of these days, one of them may even say something informative.
Inside The Sun - Consisting mostly of hydrogen, the temperature reaches almost 16,000,000 K (about 29,000,000 F).
Intellectuals - They think they're so smart.
Ireland - Island of the British Isles, west of Great Britain. Known for its distinctive traditional dance and music.
Israel - Located on the Mediterranean, the state of Israel was reated by a 1948 U.N. mandate.
Italy - European Republic, shaped like a boot - a very fashionable boot.
Jack Nicholson - 1937- , American motion-picture actor of "Chinatown," "Terms Of Endearment" and "The Shining." He's as good as it gets!
Jack The Ripper - Accused of murdering six women in 1888, and suspected in other murders. Still at large.
Jackie Chan - 1954-, actor, director, martial artist. Screen name, Sing Lung, means "Becoming the Dragon." That's "MISTER Becoming the Dragon" to you!
Jacques Cousteau - 1910-97, French naval officer, marine explorer, and author. Best known as a documentary filmmaker.
Jamaica - Third largest island of the Greater Antilles, south of Cuba. Tropical climate, reggae music, and jerk cooking.
James Bond - Fictional British secret agent created by English author Ian Fleming. Shaken, but never stirred.
James Dean - 1931-55, American actor of film, stage, and television. His role in Rebel Without a Cause helped define "cool."
Japan - An Asian constitutional monarchy. The capital city is Tokyo. Let's see ... sushi, Godzilla, earthquakes ...
Japanese - How many Japanese does it take to screw in a light bulb? Who needs light bulbs when you've got OUR new technology!
Jelly Beans - Well, as long as we HAVE to eat our vegetables ...
Jennifer Lopez - 1970-, American singer and actor of Selena, Money Train, and Maid In Manhattan.
Jerry Springer - 1944- , controversial talk-show host. Don't those people know that millions of us are watching?
Jesse Jackson - 1941-, American civil rights leader. Named to "The Gallup List of Ten Most Respected by Americans" for ten years.
Jesse Ventura - 1951-, wrestler, Navy Seal, and former governor of Minnesota. Author of I Ain't Got Time To Bleed.
Jim Carrey - 1962- , Canadian comedian and actor. Famous for outrageous faces, and dumb and dumber characters.
Jimmy Stewart - 1908-97, America's favorite self-image. Mr. Smith Goes to Washington, Rear Window, Vertigo, and It's a Wonderful Life, ... and it probably was.
Joan Of Arc - 1412-31, patron saint of France who decisively turned the tide of the Hundred Years' War, which really burned her up.
Jodie Foster - 1962- , American actor began her career on Mayberry, R.F.D. and went on to win Academy Awards for The Accused and Silence Of The Lambs.
John F. Kennedy - 1917-63, 35th president of the US. "Ask not what your country can do for you; ask what you can do for your country."
John Glenn - 1921- , The first U.S. astronaut to orbit the earth in 1962, and a U.S. Senator. Never too old to shoot for the moon!
John Philip Sousa - 1854-1932, American bandmaster and composer of Stars and Stripes Forever. Known as "The March King."
John Travolta - 1954 - , American actor of "Welcome Back, Kotter," "Grease," "Saturday Night Fever" and "Pulp Fiction." That man can dance!
Judge Judy - Ms. Sheindlin presides over real-life cases on this TV courtroom show. "I'm the boss, applesauce!"
Julia Roberts - 1967-, American actor and Pretty Woman. Also starred in Steel Magnolias, My Best Friend's Wedding, and Erin Brockovich.
Junk Mail - Contests, credit card applications, solicitations and political ads.
Jupiter - Story Problem: If one year on Jupiter equals 11.86 Earth years, and one day equals 9.92 Earth hours, how many Earth hours are there in a Jupiter year?
Katherine Hepburn - 1909-2003, American actor and winner of four Academy Awards. She starred in such classics as The African Queen.
Keanu Reeves - 1964- , American actor of Bill And Ted's Excellent Adventure, The Matrix and Speed. Keanu means "cool breeze over the mountains."
Killer Whales - Black and white predatory whales. Boy, can they sing!
Kilts - If Mel Gibson can wear one, so can you.
King Arthur - Legendary British king best known for Camelot and round tables.
King Henry VIII - 1491-1547, King of England, and founder of the Church of England. Six wives, no waiting.
Knock-Knock Jokes - Who's there?
Labor Unions - Look for the Union label. And, while you're at it, look for Jimmy Hoffa ...
Large Mouth Bass - Oh, please, let it not sing ...
Las Vegas - The first casino opened in Las Vegas in 1946. Las Vegas ... or it that Lost Wages?"
Lawyers - We'd throw some joke in here, but we're afraid of getting sued.
Leaf Blowers - Toro, Toro, Toro!
Leather - Animal hide. Leather you like it or not.
Leeches - Any mention of lawyers, agents, or reporters would be FAR too easy ...
Lemons - When life gives you lemons, make lemonade ... or, in the case of a car, take it back. There's a law, you know!
Lenin's Tomb - We'd love to visit Lenin's Tomb, but it's probably just another communist plot.
Leonardo Da Vinci - 1452-1519, Florentine artist, sculptor, architect, engineer, scientist, and all-around smartypants.
Lightning - Electrical discharge between rain clouds, or between a rain cloud and the earth, or between a rain cloud and an idiot with a kite.
Loan Sharks - As dangerous as "Jaws", but without the charisma.
Lobster - Crustaceans closely related to freshwater crayfishes. Market price.
Local Police - They know who you are and they know where you live.
Log Cabins - Among the many Americans born in log cabins were Preisdents Harrison, Lincoln, and Grant. Just pass the maple syrup.
Lollipops - Sucker!
London - Founded even before the Romans reached England's shores, now the capital of Great Britain.
Looking For A Job - Will work for fool ...
Los Angeles - LA LA Land.
Losing Your Job - They just didn't understand me!
Lucille Ball - 1911-89, American actor and comedian. You love Lucy? I love Lucy.
Machine Guns - Automatic, rapid-fire, repeating weapons. The Gatling gun was used as early as the American Civil War.
Mad Cow Disease - Degenerative brain disorder in cattle. The reason they don't know enough to come in out of the rain?
Madame Curie - 1867-1934, French chemist and physicist who won a Nobel Prize for her work on radiation. Fun fact: A "curie" is a unit of radioactivity.
Madonna - 1958-, American singer, songwriter, actor, writer, and 1980s pop icon. Blond Ambition.
Magic Tricks - "Nothin' up my sleeve ..." - Bullwinkle
Mahatma Gandhi - 1869-1948, Indian leader and philosopher who preached nonviolence. Was assassinated for his efforts.
Manhattan - I'll take Manhattan!.
Mardi Gras - Fat Tuesday marks the final day before the Christian fast of Lent, a 40-day period of self-denial and abstinence. SO LET'S PARTY!
Marilyn Monroe - 1926-62, American movie star, pinup and sex symbol. Just ask the Kennedys.
Mark Twain - 1835-1910, American writer and humorist, best known for the adventures of Tom Sawyer and Huckleberry Finn.
Marriage - If love and marriage go together like a horse and carriage ... who's the horse?
Mars - The fourth planet from the sun. Where men come from.
Martha Stewart - 1941-, television personality, magazine editor, and author. Domestic arts are her stock-in-trade.
Martin Luther King, Jr. - 1929-68, American civil rights leader and advocate of nonviolent resistance. Was assassinated for his efforts.
Meat Cleavers - No relation to Ward, June, or the Beaver ...
Meatloaf - Large and intimidating -the dish not the singer!
Meg Ryan - 1961- , American actor and girl-next-door star of When Harry Met Sally, Sleepless In Seattle, and You've Got Mail.
Mel Gibson - 1956-, Australian actor. Known for The Road Warrior, Braveheart and :eatha; Weapon I, II, III, IV ...
Men - REAL Men.
Men In Black - We're not here. You don't see us. The government did NOT send us.
Meryl Streep - 1959-, accomplished American actor, two-time Oscar winner, with over a dozen Academy Award nominations.
Mexico - Federal republic in North America. The capital and largest city is Mexico City.
Mice - "The best-laid schemes o' mice an' men ..." -Robert Burns
Michael Jackson - 1958-, American popular singer, dancer, and songwriter. Welcome to Neverland.
Michael Jordon - 1963- , American professional basketball legend, led Chicago to six world championships. No bull.
Michelangelo - 1475-1564, inspired Italian sculptor, architect, painter, and poet. A REAL Renaissance man.
Michelle Pfeiffer - 1957-, American actor whose career began with Grease 2. She'd like us to forget that but remember her Oscar nominations.
Microsoft - A leading American software company. We'd say more but we don't want to monopolize your time ...
Midlife Crisis - "Here comes your 19th nervous breakdown ..." -The Rolling Stone
Mike Tyson - 1966- , American heavyweight boxer. Lend him your ear ...
Miles Davis - 1926-91, innovative, influential, and respected American jazz trumpter player and band layer.
Milk - Three glasses a day will give you ... the gratitude of the dairy industry.
Milk Duds - Chocolate and caramel candy balls. Tooth extractions at no extra charge!
Mirrors - And now, a moment for reflection.
Mold - Fuzzy growth produced on organic matter by several types of fungi. Particularly attracted to students' refrigerators
Money - "The best things in life are free/ But you can give them to the birds and bees/ Just give me money ..." -Bradford and Gordy
Morticians - Why do you hang around with THOSE stiffs ...?
Mosquitoes - They suck.
Motorcycles - The air in your hair and bugs in your teeth.
Mount Rushmore - Memorial carved into the side of the Black Hills in South Dakota. Heads above all other monuments.
MTV - "Video killed the radio star." -The Buggles
Mud - Water. Dirt. You do the math.
Mudslides - Chocolate drink or natural disaster ... both occur frequently in California.
Muhammad Ali - 1942- , American heavyweight boxing champion. "Floats like a butterfly, stings like a bee."
Musicals - South Pacific, The King and I, The Sound of Music, A Chorus Line, Cats, Rent ...
My 16th Birthday - Dad, can I have the keys to the car, please?
My Bank Account - Speaking of theoretical mathematics and unreal numbers ...
My Bathroom - "The bathroom was drenched with their splashings" -Aldous Huxley
My Bedroom - "No one knows what goes on behind closed doors." -Charlie Rich
My Body - Mine is a temple. Specifically, the Temple of Doom ...
My Boss - ... is an idiot. You know it; we know it.
My Dreams - "What dreams may come ..." -Shakespeare's Hamlet
My Family - They'll drive you nuts. As long as you do the same to them, it's all even.
My First Kiss - Sparks were flying. Of course, that could have been the braces ...
My Friends - With friends like there, who needs enemies?
My Future - "The future's so bright, I gotta wear shades ..." -Timbuk-3
My Hair - Hair today, gone tomorrow ...
My High School Prom - As if adolescence isn't awkward and painful enough ...
My Job - Love it or leave it.
My Love Life - "All you need is love ..." -The Beatles
My Mind - It's a terrible thing to waste.
My Neighborhood - "Please, won't you be my neighbor?" -Fred Rogers
My Past - What's past is past ... unless you're a politician ...
My Personality - "I'm good enough, smart enough and, gosh darn it, people like me." -Stewart Smalley played by Al Franken
My Refrigerator - It's a science experiment!
Napoleon Bonaparte - 1769-1821, Emperor of France. Met his Waterloo at the Battle of Waterloo. The name should have tipped him off ...
NASCAR - Stock car racing began after World War II, breaking records for speed and for the number of advertisements on a single jacket.
Neil Simon - 1927-, American producer, playwright, and screenwriter of The Odd Couple, Biloxi Blues, The Sunshine Boys, California Suite, and many more.
New Orleans - The Big Easy.
New Shoes - Make you feel like dancing ...
New York City - America's most populous city. So good, they named it twice.
Niagara Falls - Niagara Falls was formed about 12,000 years ago, when glaciers retreated north, and honeymooners approached from the south.
Nicholas Cage - 1964- , American actor known for his edgy characters in Leaving Los Vegas, Raising Arizona, and Moonstruck.
Ninjas - Teenage mutant turtles need not apply.
Nobel Peace Prize - Established by Alfred Nobel. Swedish industrialist and inventor of dynamite. Led to an explosion of peace efforts.
Noisy Neighbors - WHAT? I CAN'T HEAR YOU!
Normal Rockwell - 1894-1978, American painter, illustrator and all-around interpreter of small town American life.
Nuclear Power Plants - "You've turned a potential Chernobyl into a mere Three Mile Island." -Montgomery Burns, "The Simpsons"
NYPD - The New York Police Department. They're so good, they have their own TV show.
Oil Spills - The American oil tanker, Exxon Valdez, went aground in Prince William Sound, Alaska, Mar. 24, 1989. Slick Move.
Olive Oil - Derived from fresh ripe fruit, which contain about 20% oil. Better than "olive" the other oils.
On-Line Shopping - Enter your credit card number now. This is a secure site ... Sure it is ...
Oprah Winfrey - 1954- , Television talk show host, actor and all-around American success story.
Oral Surgery - You said a mouthful.
Oranges - Face it ... nothing rhymes with orange.
Oxygen - Oxygen was discovered in 1774. You'd think someone would have noticed it earlier.
Pablo Picasso - 1881-1973, Spanish painter and sculptor, one of the greatest artists of the 20th century. If only he could draw eyes ...
Parenting - The process of discovering you are becoming just like YOUR parents.
Paris, France - The governmental, cultural and gastronomic capital of France. Or the world. Just ask the French.
Paying Bills - Also known as "Debt Restructuring."
Paying Taxes - Death or Taxes? Do we have to choose right away?
Penguins - Flightless, aquatic birds that reside in the Southern Hemisphere. All dressed up and no place to go.
Picking Your Nose - Noses run in our family.
Pigeons - Birds with small heads, short necks, stout bodies, and an incredible attraction to statues.
Pigs - Domesticated mammal of the swine family. Thaaa ... thaaa ... that's all, folks!
Piranha - Carnivorous fish found in rivers of South America. When you feel like a bite ...
Pirates - "Yo, ho, yo, ho, a pirate's life for me ..." - Pirates of the Caribbean
Pit Bulls - Any of several crossbreeds of bulldogs with terriers. Or, several radio hosts we could mention.
Plane Crashes - Statistically safer than driving ... unless you crash.
Plastic - Giant molecules of organic polymeric materials. Bags and bags of the stuff.
Playing Chess - Has tantalized many of the world's greatest minds for almost 14 centuries. It just confuses the rest of us.
Poison Ivy - Itching for a walk in the woods?
Pokemon - Cute cartoon monsters you gotta catch. What you do with them is up to you ...
Pond Scum - Simple organisms that carry out photosynthesis ... or spammers.
Poodles - The only breed that is better groomed than their owners.
Popcorn - Air poppers are for air heads ... I say bring on the butter!
Porsche Boxster - A two-seat, six cylander roadster - elegant design and superior drivability.
Postal Workers - "Neither snow, nor rain, nor heat, nor gloom of night, stays these couriers from the swift completion of their appointed rounds."
Power Tools - "More power! More power! Argh! Argh!" -Tim, the Tool Man, Taylor, "Home Improvement"
Prince Charming - The perfect man ... mythical, of course.
Princess Di - 1962-97, beloved English Princess who died in an auto crash. "Good-bye England's Rose ..." -Elton John
Pro Wrestling - They're just faking it. But then, so are we.
Psychiatrists - "And how do you feel about that?"
Psychics - The Psychic Friends Network went bankrupt in 1997. Perhaps they should have seen it coming ...
Public Radio - "Good morning . . . . . This morning . . . . . . . . . . . .we have Wolfgang . . . Amadeus Mozart . . . for your listening pleasure . . ."
Puff Daddy - 1971- , American rap artist. "I'll be Missing You" shot him to stardom; no pun intended.
Pulling Weeds - It's either this or chemical warfare.
Pumping Iron - When a great weight needs to be lifted.
Pushups - Exercises, a type of bra, or the ice cream treat.
Pyramids - Built by ancient civilizations, found mainly in Egypt, Guatemala, Honduras, Mexico and Peru. Probably the result of some pyramid scheme.
Quentin Terantino - 1963- , Groundbreaking American director and actor. Nice movies, but not nearly enough blood.
Quicksand - Just don't let it get you down.
Ragweed - A weed of the genus Ambrosia. Nothing to sneeze at.
Rain - "When the rain comes, they run and hide their heads; they might as well be dead." -The Beatles
Rainbows - "Someday they'll find it/ The Rainbow Connection/ The lovers, the dreamers and me ..." -Kermit the Frog
Rappers - PAENTAL ADVISORY EXPLICIT CONTENT Hasn't seemed to hurt sales...
Reading A Good Book - So many books, so little time.
Recreational Vehicles - If they're trying to get away from it all, why are they taking it all with them?
Recycling - More than one million tons of aluminum are NOT recycled each year. Where do you throw your cans?
Red Raspberries - Worth a few scratches.
Rednecks - "You might be a redneck if ..." -Jeff Foxworthy
Redwood Forests - "From the Redwood Forests to the Gulf Stream Waters/ This land was made for you and me." -Woody Guthrie
Reggae Music - This contemporary Caribbean music, originating in Jamaica, remains an influential style of popular music. Ya mon!
Regis Philbin - 1934- , American talk and game show host. Who wants to be a millionaire? Regis, apparently.
Remote Controls - The world's handiest invention. That is, if you can find it.
Republicans - A U.S. political party symbolized by an elephant ... and don't forget it!
Richard Nixon - 1913-94, 37th President of the United States and the only president to have resigned from office. At least that's what the tapes say ...
Robert DeNiro - 1943- , Pre-eminent American actor who earned Academy Awards for The Godfather II and Raging Bull. "Are you looking at me?"
Road Kill - Mmmmmm. Them's good eatin'.
Road Trips - "Get Your Kicks on Route 66." -Nelson Riddle
Robin Williams - 1952- , versatile American comedian and actor. The furriest man in show business.
Rock And Roll - It's here to stay!
Rock Concert - If it's too loud - you're too old.
Rocket Scientists - Hey! They're not rocket scie ... oh ... never mind.
Rocky Mountains - These extend 2,000 miles from northeastern British Columbia to central New Mexico, and keep the Californians away from everyone else ...
Rolling The Car - You'll flip for this one ...
Roman Numerals - There's a I in VII chance you'll know them.
Romeo And Juliet - William Shakespeare's best known play, written in 1595. Youthful love and hasty temperaments.
Root Beer Floats - Actually, it's the ice cream that floats!
Rosa Parks - 1913-, civil rights icon arrested in 1956 for violating U.S. segregation laws by refusing to give up her bus seat to a white passenger.
Rosie O'Donnell - 1962-, American actor and comedian. She's in a league of her own!
Rubber Gloves - Just in case ...
Running A Marathon - 26 miles, 385 yards: the distance run by a Greek soldier from the town of Marathon to Athens in 490 BC.
Rush Limbaugh - 1951- , conservative talk-radio personality. Claims to host his radio show with half his brain tied behind his back, just to make it fair.
Russia - The world's largest country, spanning 11 time zones. Famous for borscht, ballet, chess and vodka -just don't mix them.
Rust - "Rust never sleeps." -Neil Young
Saddam Hussein - 1937-, dictator of Iraq 1979-2003.
Sailors - "In the Navy, you can sail the seven seas ..." -The Village People
Salads - Lettuce not knock the vegetarians.
Salsa Dancing - Popular form of Latin American dance. A little jazz, a little blues, a touch of rock and lots of heat.
Salvador Dali - 1904-89, Spansih artist best known for his dream imagery and surrealism, including the limp watches in The Persistence Of Memory.
Samuel L. Jackson - 1948-, powerful American actor of Pulp Fiction, Jackie Brown, and The Negotiator.
Saturday Cartoons - Get your blanket, a bowl of cereal and snuggle in for three hours of commercials.
San Francisco - California's City by the Bay. Where many hearts are left.
Saturn - Sixth planet from the sun, and the second largest in the solar system. Has a nice ring to it, don't you think?
Scavenger Hunt - OK kids, here's your list: a marshmallow, a safety pin, a red rubber band, and a moon rock. Go find 'em!
Scene Of The Crime - It was Colonel Mustard, in the library, with the candlestick.
Schindler's List - 1993 Steven Spielberg film. Powerful real-life story of a Catholic businessman who eventually saved over 1000 Jews in Nazi Poland.
Science Fair Projects - No human subjects, please!
Science Fiction - In a galaxy far, far away ...
Screeching - Please stop.
Sean Connery - 1930- , Accomplished Scottish actor, although best known as the REAL Bond, JAMES Bond ...
Shania Twain - 1965- , Canadian country singer and songwriter. "Shania" means "I'm on my way" in Ojibwa.
Sharks - Many species living today are similar to those from 100 million years ago. Because change is scary.
Shopping Mall - Three-quarters of the North American population visit a shopping mall at least once a month.
Silk - Produced as a cocoon covering by the silk worm, and used in fine fabrics and textiles.
Silly Putty - It's putty in your hands!
Skateboarding - It's just going downhill ... down stairs ... down ramps ...
Skiing - The Super Giant Slalom: Swiss for "suicide."
Skinheads - Shaved heads, big boots. Some are Nazis, some are not.
Skunks - Black and white striped mammals known for their offensive smelling defensive spray.
Skydiving - Parachute canopies are usually made from nylon fabric that lasts for thousands of jumps - whether the skydiver does or not.
Sleeping Pills - I remember taking them ... I just ... don't rememmer ... how mamy.
Slivers - Also known as splinters. The worst ones are under your fingernails.
Sloppy Joes - My favorite recipe -open the can.
Smithsonian Institution - Located in Washington, D.C., the largest museum complex in the world. Wouldn't that be a great garage sale?
Snakes - Surprising, snakes move rapidly without legs. Also surprising, they find OTHER snakes attractive.
Snow - Transparent ice crystals which form around dust and other small particles. Get my drift?
Social Security - American program designed to provide income and services in the event of retirement, sickness, disability, death or unemployment.
Socks - "Black socks, they never get dirty, the longer you wear them the stronger they get." -Bill Harley
South Africa - Two oceans, rugged mountains, traditional villages, game sanctuaries, wineries...forget the past and bring on the tourists.
South Park - Highly-rated, highly offensive animated cartoon series. "Oh my God! We killed Kenny!"
Soy Sauce - A brewed seasoning made from soybeans, wheat, and salt.
Spam - Mystery meat, or mystery E-mails ...
Speeding Tickets - "No, officer, I don't have any idea how fast I was going."
Spiders - There are more than 34,000 species of spiders. Try not to think about THAT right before bedtime.
Spike Lee - 1957-, American film maker and Knicks fan. Best known for Do the Right Thing, Malcolm X, and 4 Little Girls.
Spilled Milk - Got milk? WHOOPS! Apparently not ...
Spit - Ladies and gentlemen, straight from the Salivary Glands ...
Spontaneous Combustion - The ignition of substances without application of an external heat source. A good plot for "The X-Files."
Sport Utility Vehicles - Need new tires?
Sports Channels - Any team, any time.
Star Fruit - Looks like plastic, tastes like lemons.
Starry Night - A sky bright with stars, a classic Van Gogh painting, and a Don McLean song. Three cards in one!
State Fair - Aw, gee whiz, a blue ribbon for Bessie!
Steak And Potatoes - Hot off the grill!
Stephen King - 1947- , American author of horror novels, who's sold more than 100 million copies of his books. Talk about frightening ...
Steve Martin - 1945- , American comedian, actor, writer, and "wild and crazy guy."
Steven Spielberg - 1947-, American movie director and producer, and overachiever. From E.T. to Schindler's List... too many to list.
Stonehenge - Prehistoric stone monument located north of Salisbury, England.
Strawberry Shortcake - Summertime and the eating is easy ...
Stubbed Toes - It'll feel better when it quits hurting.
Stunt People - When you need someone to take the fall.
Summer Camp - If the bugs don't get you, the poison ivy will!
Sunday Drivers - Now available ANY day of the week!
Superman - Fictional comic book superhero loved by Lois Lane and Jerry Seinfeld.
Supermodels - Long legs = big bucks.
Surfing The Net - www.otb-games.com
Sushi - Who would ever have guessed that raw fish could be so fashionable?
Swiss Bank Accounts - Do you think everyone in Switzerland has one?
Swiss Chocolate - "What use are cartridges in battle? I always carry chocolate instead." -George Bernard Shaw
Swiss Cheese - Guess it comes from holey cows ...
Taking A Bath - Bathing facilities have been found in excavations in India from before 2000 BC. Soap-on-a-Rope hasn't.
Talk Radio - Talk about air pollution.
Teachers - If you can play this game, thank a teacher.
Telemarketers - "No, thank you ... No, I'm not interested ... No, I have to go now ..."
Televangelists - Not to be confused with Teletubbies.
Television - One-hundred and sixty-four channels, and nothing worth watching.
Telling The Truth - "There are two kinds of truth. There are real truths and there are made-up truths." -Marion Barry, ex-mayor of Washington, D.C.
Terrorist Attack - We will never negotiate with terrorists.
Thanksgiving Day - The fourth Thursday of November in the U.S.; the second Monday in October in Canada.
The 1920s - Pros: the Jazz Age. Cons: Presidents who look like librarians.
The 1950s - Pros: Barbies, barbecues, and bikinis. Cons: McCarthy, the Korean War, television.
The 1960s - Pros: the Moon Lsnding, the music. Cons: hippies who refuse to believe they're over.
The 1970s - Pros ... uh ... pros ... uh ... GIVE US A MINUTE, OKAY?
The 1980s - Pros: meant the end of the 1970s. Cons: '80s nostalgia.
The 21st Century - The future is NOW!
The Academy Awards - The statue known as "Oscar" weighs only eight and a half pounds. So why does it carry so much weight?
The Beach - A day at the beach is no day at the beach, ya know?
The Beatles - 1960s British band. Only the most revolutionary, influential and universally acclaimed group of the 20th century. That's all.
The CIA - The Central Intelligence Agency is responsible for keeping the U.S. government informed of foreign actions affecting the nation's interest.
The Cold War - The post-World War II struggle between the US and its allies, and the former USSR and its allies. Things could have gotten hot.
The Common Loon - A spotted, red-eyed diving bird -or various friends or family.
The Dallas Cowboys - National Football League team known for their cheerleaders and their performance, both on and off the field.
The Dump - Just remember to recycle.
The Eiffel Tower - Designed and built by French engineer Alexandre Gustave Eiffel for the Paris World's Fair of 1889.
The Electric Chair - In U.S. prisons, an alternating current of about 2000 volts is used for electrocution.
The End Of The World - "It's the end of the world as we know it, and I feel fine ..." -REM
The Everglades - A vast marsh covering much of southern Florida. Watch out for alligators!
The Far Left - They get high Marx from some.
The Far Right - Far right for some and far wrong for others.
The FBI - The Federal Bureau of Investigation: the investigative agency for the U.S. Department of Justice. They're listening ...
The First Day Of School - "Fear has many eyes." -Cervantes
The French Riviera - Holiday home of the rich, the famous, and the half-naked.
The Godfather - The 1972 critically acclaimed Mafia movie that made us as offer we couldn't refuse.
The Grand Canyon - 217 miles long, 4 to 18 miles wide, and more than 1 mile deep. Now THAT'S grand.
The Grateful Dead - American rock band, founded in 1965 and best known for their "Dead Head" fans.
The Great Chicago Fire - The noteworthy fire of 1871 ... a hot time in the old town ...
The Great Depression - Prozac was invented six decades too late.
The Green Bay Packers - Twelve time National Football League world champions, beloved by "Cheeseheads" everywhere. Are those brats done yet?
The Gulf War - January - February, 1991. This six week conflict with Iraq was also known as "Desert Storm."
The Indy 500 - Contestants must drive the full 500 miles. Bathroom breaks ARE allowed.
The Internet - Computer-based worldwide information network, and global shopping market.
The IRS - The Internal Revenue Service: agency of the U.S. Department of the Treasury responsible for collecting taxes. A human audity.
The JFK Assassination - November 22, 1963. The funeral of President Kennedy was watched on television by millions around the world.
The KKK - If they're supposed to be the master race, why do they keep misspelling "Clan"?
The Land Of Oz - "I've a feeling we're not in Kansas anymore, Toto." -Dorothy, "The Wizard Of Oz"
The Little Mermaid - The 1837 story by Hans Christian Anderson or the 1989 animated film by Disney. Guess which made more money?
The Mafia - A loose association of criminal groups, bound by a blood oath and sworn to secrecy. Of course, now we have to kill you.
The Marx Brothers - Chico, Groucho, Harpo, amd sometimes Zeppo. Their 1930s films include Duck Soup and Animal Crackers.
The Metric System - No, thank you. We like our inches and feet!
The Midwest - America's central plains states. They're not like folks 'round here ...
The Milky Way - The galaxy that includes the sun, its solar system, and a chewy layer of caramel.
The Mississippi River - The Algonquin words "Misi sipi" mean "big river." What's Algonquin for "muddy"?
The National Enquirer - American tabloid newspaper. Inquiring minds want to know ... Why the heck does this thing sell?
The New York Yankees - Legendary American baseball team. With so much success, it's obvious why they're reviled.
The NRA - National Rifle Association. They're gunning for your vote.
The Ocean - How deep is the ocean? 12,000 feet. If they'd known that, maybe they wouldn't have written that stupid song.
The Old Man And The Sea - Ernest Hemingway's classic novel - fishing, hunger, fishing, torment, fishing, personal loss ... fishing ...
The Olympics - An international athletic competition held every four years. The thrill of victors and the agony of defeat.
The Opera - It ain't over 'til the fat lady sings. Unfortunately, sometimes, not even then.
The Ozone Layer - Short for ozonosphere. Theories about the ozone layer are full of holes.
The Pentagon - The five-sided home of the U.S. Department of Defense.
The Pyramids - The Egyptian pyramids were built from about 2700 BC to about 1000 BC. Tut, tut, tut ...
The Renaissance - Beginning in the 1300s, started in Italy and spread across Europe. Kind of like Espresso bars ...
The Rolling Stones - British "bad boy" rock band formed in 1962. Still touring?
The San Andreas Fault - Geological feature in California stretching 600 miles. Like the state doesn't have enough faults already.
The South - Dixie: South of the Mason-Dixon line, that is. They're not like folks 'round here ...
The Statue Of Liberty - "Give me your tired, your poor/ Your huddled masses yearning to breathe free ..." -Emma Lazarus
The Super Bowl - Who needs another national holiday?
The Supreme Court - The highest court in the United States. Robes, but no wigs.
The Three Tenors - Opera stars Placido Domingo, Jose Carreras, and Luciano Pavarotti began recording as The Three Tenors in 1990.
The Titanic - It sank in 1912. Get over it!
The Universe - Everything. The big "It." Huge. Massive. THAT big.
The Vatican - The Papal State in the middle of Rome. Home of the Pope, Swiss Guards, and lots of pigeons.
The Vietnam Memorial - "The Wall," built in 1982, was designed by 21-year-old architecture student, Maya Lin.
The Williams Sisters - Venus, 1980-, and Serena, 1981-, Williams, American tennis champs. One heck of a sister act.
The Wright Brothers - In 1903, Wilbur and Orville made the first powered airplane flights in history. Although there were delays at the airport.
The YMCA - The Young Men's Christian Association has 30 million members in 110 countries. "It's fun to stay at the Y-M-C-A." -The Village People
Thomas Edison - 1847-1931, American inventor, developed a light bulb, generator, sound-recorder, and motion picture projector. Show off.
Thunder - "Here it comes again, Thunder and Lightning..." -ELO.
Tibet - Mountainous region of China and religious enclave for a form of Buddhism called Lamaism. Known as the roof of the world.
Ticks - All ticks are bloodsucking parasites, but not all bloodsucking parasites are ticks.
Tidal Waves - The gigantic ocean waves that strike with tremendous force, and cause considerable damage to life and property. Kind of like Spring Break.
Tiger Woods - 1975- , American star of the golf circuit. Known for his athletic skill, and youthful, classic style.
Toasted Marshmallows - How do you like yours - golden brown or flaming?
Toasters - Wait -don't stick that fork in there!
Tobacco Companies - Who says tobacco's not addictive? THEY can't give it up ...
Toes - "This little piggy went to market ..."
Tom Cruise - 1962-, American actor. It looked like Ricky Business early on, but by 1986 he was Top Gun. No Mission Impossible for him.
Tom Hanks - 1956-, American actor and star of such varied films as Big, Philadelphia, Forrest Gump, Saving Private Ryan and Castaway.
Top Of A Rollercoaster - Just remember: what goes UP ...
Tornadoes - Funnel-shaped cloud whirling destructively at speeds up to 300 mph. "Honey, do you hear a freight train ... Honey?"
Toys - They're not just for kids, anymore ...
Trailer Parks - Also known as tornado magnets.
Trampolines - Trampolines have been used in circuses wince the 18th century. Despite slumps in popularity, they always seem to bounce back!
Tree Huggers - "Environmentalists" to the left. "Wackos" to the right.
Truck Stops - Breakfast 24 hours a day and you're on your way.
Tyrannosaurus Rex - Large carnivorous dinosaur of the latter part of the Mesozoic era. My, what big teeth you have!
Underwear - "Let's keep this brief."
United Nations - The U.N. was founded in 1945, after World War II ended. Its mission is to maintain world peace. If we ever achieve it, that is ...
Vacations - "Vacation, all I ever wanted, Vacation, had to get away ..." -Go-Go's
Vampires - Legendary bloodsucking monsters.
Victorian England - An era characterized by moral severity and pompous conservatism.
Video Games - Just how DO you get to the thirteenth level of "Doom"?
Vietnam, 1968 - More than 30,000 Americans had been killed in the Vietnam War by the end of 1968.
Vincent Van Gogh - 1853-90, Dutch post-impressionist painter known for dramatic sunflowers and self-portraits. Only one of his paintings sold during his lifetime.
Violins - It's a pain in the neck, but keep practicing.
VW Beetles - The prototype for the original VW Beetle was developed in 1934, and production begin in 1945. Functional, yet so fashionable.
Waco, Texas - Texas city near where a 51-day standoff between law-enforcement officials and members of the Branch Davidians occurred in 1993.
Wall Street - The financial center of the United States. See also: roller coaster.
Walt Disney - 1901-1966, the head of some Mickey Mouse company.
Warts - Small, benign, circumscribed tumors of the outer layer of the skin. Warts and all!
Watching Football - Sheer athletic prowess by players in peak physical condition is a glorious thing to behold. Pass the chips and beer.
Water Parks - You can go down Dead Man's Drop and I'll take the Lazy River.
Waterbeds - Could serve as a safety precaution for those who smoke in bed.
Waterfalls - "Don't go chasing waterfalls..." -TLC
Watermelons - Pardeeville, WI - home of the Watermelon Seed-Spitting & Speed-Eating Championship. The record is 2.5 lbs. of melon eaten in 3.5 seconds.
Weapons Dealers - OK, what kind you need? Assault, Automatic, Atomic ...?
Weddings - "Ding, dong, the bells are gonna chime ..." -My Fair Lady
Wheat - Mainly used in flour. World output of wheat is more than 600 million metric tons a year ... so someone's making a lot of dough.
Wheel Of Fortune - American TV game show, BIG MONEY! BIG MONEY!.
Whipped Cream - Great on strawberry shortcake, banana splits, chocolate pudding ...
Whips - "Crack that whip ... whip it, whip it good." -Devo
Whoopie Goldberg - 1950-, American actor and comedian. Starred in such movies as Ghost, which earned her an Academy Award. Whoopee!
Will Smith - 1968- , Successful American rap star, TV star and wildly successful motion picture star. He's got it all. We hate him.
William Shakespeare - 1564-1616, The English poet and playwright. And all the world IS a stage ...
Wimbledon - Strawberries ... cream ... temper tantrums ...
Windsurfing - Really just surfing for lazy people.
Wine Tasting - Spit or swallow?
Winning The Lottery - The more you play, the more THEY win.
Witch Hunts - Popular locations: Salem, Massachusetts and Washington, D.C.
Women - REAL Women.
Women's Soccer - The 1999 World Cup finals was the most-watched women's sporting event in history.
Wood Chippers - "I guess that was your accomplice in the wood chipper." -Marge Gunderson, Fargo
Woodstock - The 1969 love, music and mud festival attended by 400,000. Or, the little yellow bird.
Woody Allen - 1935- , American comedian, actor and director, of Bananas, Annie Hall, Hannah and Her Sisters, and lots of New York Stories.
Worms - "A man may fish with the worm that hath eat of a king, and eat of the fish that has fed of that worm." -"Hamlet" Shakespeare
X-Ray Vision - Available to Superman -for emergency use only.
X-Rays - X-Rays were discovered in 1895 by the German physicist Wilhelm Conrad Roentgen. Now if they could just get those X-ray glasses down.
Yellowstone Park - Home to 3000 geysers and hot springs. More gas and hot air than Washington, D.C.
Zen - Japanese form of Buddhism, originated in China. Zen again, maybe not.
Zucchini - A squashed vegetable.
A Cabin In The Woods - Henry David Thoreau went to Walden Pond for two years. All we're asking for is one lousy weekend!
A Can Of Worms - Now you've opened it.
A Few Good Men - Is that too much to ask?
A Fool & His Money - Are soon parted... especially on Wall Street.
A French Maid - Ooh, la, la!
A Hole In One - Par for the course?
A Little White Lie - If you can't say anything nice . . .
A Million Dollars - If I had a million dollars. . .
A Mummy - "Walk like an Egyptian." - The Bangles
A Ringing In My Ears - Answer that, would'ya?
A Spare Tire - The good news is: we have a spare tire . . .
Abbot & Costello - Comedy team who had everyone guessing - "Who's on first?"
Adam & Eve - A relationship of Biblical proportions.
Alan Greenspan - 1926-, chairman of the U.S. Federal Reserve Board.
AM & FM - Making waves in radio.
Amsterdam - The capital of the Netherlands, and one of Europe's most beautiful and notorious cities.
Ancient Rome - In ancient times, all roads led to Rome, and the traffic has only gotten worse.
Anna & The King - The 1999 film romanticizing the story of Anna Leonowens and King Mongkut of Siam.
Anna Kournikova - 1981-, Russian-born star of the tennis court and internet.
Anthrax - A potentially deadly infectious disease caused by spore bacteria. Anthrax has been developed as a biological weapon.
Antiques Roadshow - PBS television program where folks bring oddities for appraisal. One person's trash is another's treasure.
Antony & Cleopatra - Roman general and Egyptian queen. A love affair that wouldn't die. Oh, wait, it did.
Apples & Oranges - Don't even TRY to compare them.
Aristotle - 384-322 B.C., ancient Greek philosopher. His writings formed the foundation for much of today's philosophical and political thought.
Arm & A Leg - Sure, they were free, but just try replacing them.
Armadillo - Burrowing mammal with armor-like bony plat covering. Roadkill extraordinaire.
Arnold Schwarzenegger - 1947-, Austrian born body-builder turned actor. "My body is like breakfast, lunch, and dinner. I don't thinkabout it, I just have it."
Aroma Therapy - Alternative medicine. Something's smelly about it.
Arsenic & Old Lace - The hilarious dark comedy written by Joseph Kesselring, or the 1944 film adaptation by Frank Capra.
Assault & Battery - That would be a single "A" battery.
Bagels And Lox - A perfect snack for salmon-chanted evening ...
Ball & Chain - Don't let it get you down.
Ballroom Dancing - Fox-trots, tangos, cha-chas, and more! Are you ready to rumba?
Barbie & Ken - Ah, to be blond and plastic...
Baseball - Its one, two, three strikes you're out . . .
Batman & Robin - Superheroes or vigilantes, you make the call.
Bats & Balls - At least they don't go on strike.
BB Guns - You'll shoot your eye out!"
Beanbag Chairs - For beanbag butts . . .
Beauty & The Beast - A French fairy tale, animated by Disney in 1991.
Beavis & Butt-Head - He said "butt." Huh-huh. Huh-huh.
Bed & Breakfast - Not the same as breakfast in bed.
Beer & Pretzels - "These pretzels are making me thirsty" - Cosmo Kramer, Seinfeld
Being & Nothingness - Jean Paul Satre's 1943 work based on the distinction between things that exist by themselves and those that exist for themselves.
Bells & Whistles - It's got everything!
Bert & Ernie - Sesame Street's muppet buddies.
Big Bird - Beloved Sesame Street character, or the not-necessarily-beloved U.S. spy satellite.
Bill & Ted - Characters in Keanu Reeves' excellent time-travel adventure film. Yeah, dude.
Billy Crystal - 1947-, American comedian, actor and director. He looks maaaaah-velous.
Black Cats - It's bad luck if they cross your path. You might step in a hairball!
Black Licorice - Alexander the Great and Julius Caesar both endorsed the beneficial properties of Licorice. No word on black jelly beans . . .
Black Lingerie - Victoria's REAL secret: selling skimpy negligees at hefty price . . .
Blackouts - They can occur at any
Blood & Tears - Don't forget the sweat.
Blue Velvet - An elegant, textured fabric, Bobby Vinton love song, or David Lynch's bizarre 1986 film about the dark side of small-town America.
Boardwalk & Park Place - Top of the line in the real estate game.
Body & Soul - Just tryin' to keep it all together.
Body Snatchers - We'd be worried, but nobody would want to snatch OUR bodies . . .
Bodybuilders - If you build it they will come.
Bonnie & Clyde - American outlaws of the 1920s, played by Faye Dunaway and Warren Beatty in the 1967 film.
Bora Bora - Volcanic island in the Pacific. Good oranges and vanilla.
Bow & Arrows - More effective than sticks and stones.
Bowling - Three strikes and you're in.
Bread & Water - Make that a baguette and a bottle of Perrier.
Breaking & Entering - "Honest, Officer, I lost my keys."
Bride & Groom - "With this ring..."
Brooks & Dunn - Extremely successful country & honky-tonk music duo. "If they don't dance, you're dead." - Ronnie Dunn
Brothers & Sisters - "You can pick your friends, but..."
Bulls & Bears - On or off Wall Street.
Bumper Cars - Much like rush hour in Chicago.
Burger & Fries - You want flies with that?"
Buttons & Bows - Cute as a button, or a bow.
Calvin & Hobbs - Bill Waterson's late, great comic strip featuring a little boy and his tiger.
Camelot - "On second though, let's not go to Camelot. 'Tis a silly place." - King Arthur, Monty Python and the Holy Grail
Carlos Santana - 1947-, guitar legend and member of the Rock and Roll Hall of Fame. Truly Supernatural.
Carrot & A Stick - The ultimate motivator... for a donkey.
Cat & Mouse - It's just a game.
Catherine Zeta-Jones - 1969-, Welsh born actor, famous for her stunning good looks, as seen in The Mask Of Zorro, Entrapment and Traffic.
Cats & Dogs - Is it raining?
Catsup & Mustard - The salsa revolution brought down their condiment empire.
Cauliflower - Goes down easy when it's cheesy.
Caviar - It's not JUST fish eggs. It's . . . fish eggs . . . that cost a fortune . . .
Chain Link Fences - Good fences make good neighbors.
Charles & Diana - A right royal marriage.
Chat Rooms - Electronic speakeasies for the information age.
Chips & Dip - No double dipping!
Chips & Salsa - Nacho average snack!
Chutes & Ladders - A game of ups and downs.
Circus Peanuts - Chewy, oragne marshmallow things shaped like peanuts. Seldom found at the circus.
Cleveland - "Cleveland rocks! Cleveland rocks!" - The Drew Carey Show
Cloned Sheep - Dolly good show!
Cockles & Mussels - "Alive--alive-o!" I think I just lost my appetite.
Colin Powell - 1937-, U.S. Secretary of State and Chairman of the Join Chiefs of Staff during the Gulf War. We'd give him four stars.
Comic Books - THIS looks like a job for . . . somebody who draws Superman!
Convenience Stores - "Thank you come again."
Cops & Robbers - When fighting crime was just child's play.
Corn Fields - Knee high by the Fourth of July.
Corned Beef & Cabbage - It's not chopped liver.
Corrugated Cardboard - When you want to think out of the box . . .
Cottage Cheese - If it's so popular, where are all the Cottage Cheeseheads?
Coughing & Sneezing - And no cure in sight.
Cowboys - Head 'em up and move 'em out!
Cowboys & Indians - How the west was won... and lost.
Crabs - As crustaceans, crabs are related to lobster and shrimp. What do they all have in common? They all go well with butter.
Crash & Burn - Try, try again.
Cream & Sugar - Do you want some coffee with that?
Crime & Punishment - Fyodor Dostoevsky's 1917 classic novel following the tormented life of the murderer Rodion Romanovich Roskolnikov.
Cup & Saucer - Tea Time!
Curds & Whey - What? It's just cottage cheese?
Currier & Ives - The lithography shop operated from 1834 to 1907 and produced over 7500 titles, all of which could have been called "Life In America."
Cut & Curl - You'll look mah-velous!
D-Day, 1944 - On June 6, 1944 the Allied forces invaded France, employing over 10,000 airplanes, 5,000 ships, and 250,000 servicemen.
Dallas & Fort Worth - The heart & soul of Texas.
David & Goliath - Bible story featuring the future king David and the Philistine giant Goliath. The bigger they come, the harder they fall.
Day Care Centers - Preschool for preschool.
Death & Dying - The only way out.
Death & Taxes - The two certainties in life.
Dinner & A Movie - And a mortgage to pay for it.
Doctors & Dentists - For a long life and healthy teeth.
Dodo Birds - A large, flightless bird of the island of Mauritius. Discovered by Europeans in 1598, extinct by 1681.
Dog Days - 101 in the shade.
Doing The Hokey-Pokey - That's what it's all about.
Dollars & Cents - "If it don't make dollars, it don't make sense." - DJ Quik
Double Thick Malts - For a double thick ice cream headache.
Dr. Evil - Arch-nemesis of Austin Powers. Riiiiiiight.
Dr. Jekyll & Mr. Hyde - Robert Louis Stevenson's 1887 novel revealing the hypocrisy and innate evilness in society. The idea came to him in a dream - a bad dream.
Dr. Laura - 1947-, American conservative talk show host and promoter of family values. HER family values, that is . . .
Drew Barrymore - 1975-, heir to the Barrymore acting dynasty. Drew starred in ET, The Wedding Singer, Charlie's Angels, and countless tabloid stories.
Drew Carey - 1958-, American comedian and television star. Whose line is it anyway? His.
Drinking & Driving - Friends don't let friends drive drunk.
Drunk Drivers - Number one highway safety problem.
Dumb Blonde Jokes - Are they just naturally funny?
Dungeons & Dragons - Popular role-playing game featuring swords, sorcery and wizards. Repeat after me: it's a game... it's only a game...
Dustin Hoffman - 1937-, highly regarded actor of The Graduate, Midnight Cowboy, and Rainman. He's an excellent driver!
Ebony & Ivory - "Ebony and ivory live together in perfect harmony." Paul McCartney
Eggplant - Without it there would be no Eggplant Parmesan.
Emergency Rooms - Brings new meaning to he word "heartthrob."
Exterminators - Bugs, rats and vermin. It's time for chemical warfare.
Fairies - Tiny, mischievous, mythical beings with magic powers. They live in Fairyland. Really.
Faith Hill - 1967-, American crossover country music artist. You just gotta have Faith.
Fame & Fortune - Everybody may have 15 minutes of fame, but fortune is another thing altogether.
Fat - I can't believe I ate the whooooooole thing.
Fear & Loathing - In Las Vegas, or anywhere else.
Ferdinand & Isabella - Late 15th century king and queen of Spain. They backed Christopher Columbus and benefitted royally.
Fertilizer - Viagra for the garden.
Field & Stream - The hunter's best friend.
Fish & Chips - Just wrap it in any old newspaper.
Flannel Shirts - Pick your plaid.
Flash Floods - Too late for sandbags!
Florence Nightengale - 1820-1910, English nurse and health-care reformer. We've been singing her praises for years.
Flowers & Candy - When "I'm sorry" is not enough.
Folk Music - When you're just fiddling around . . .
Food & Shelter - Gotta have it.
Food Poisoning - This chicken tastes kinda funny . . .
Foot & Mouth - An infectious disease of animals with hooves. Not the same as foot-IN-mouth disease which affects everybody at one time or another.
Forever & Ever - "Oh, baby, I'm gonna to love you forever/ Forever and ever amen." Randy Travis
Fortune Cookies - "You will soon eat a flat, dry, tasteless cookie . . ."
Freaks & Geeks - The 1999 television show, or those outside the social norm.
Fred & Ginger - Fred Astair & Ginger Rogers - tap dancing their way into the hearts of millions.
Fred & Wilma - Meet the Flintstones. "Yabba-dabba-doooo!"
Fred Flintstone - Yaba-daba-dooooo!
Friends & Family - There when you need them.
Frisbees - The frisbee was introduced to the market in 1948. Take one for a spin.
Frog & Toad - Characters in a series of children's books by Arnold Lobel, or any of the millions of frogs and toads who choose not to wear clothes.
Gardening - Get in touch with your roots.
George & Jane, His Wife - The Jetsons television show first aired in 1962. In spite of our best efforts, cars still can't fly.
Gettysburg, 1863 - The turning point of the American Civil War, a bit more than four score and seven years ago.
Ghosts & Goblins - "I see dead people." - Cole Sear, The Sixth Sense
Gilligan's Island - Who would have thought that you could make a radio out of coconuts.
Ginger & Mary Ann - "Here on Gilligan's Isle."
Giraffes - Giraffes can grow to 18 feet tall and have been known to kill a lion with a single kick. Not just another pretty face.
Go Karts - Go kart, go!
Going On A Cruise - Iceberg, dead ahead!
Gold & Silver - There's a good reason Fort Knox is full of golg and not silver.
Good & Plenty - The licorice candy was first produced in 1893, making it the oldest branded candy in the United States.
Goose & The Gander - If it's good for the goose...
Gourmet Coffee Shops - I'll have a tall, double cappuccino, wet, with vanilla, half decaf, - to walk.
Grease - Pretty slick!
Grease & Grime - What would Martha do?
Haiku - Traditional form of Japanese poetry consisting of three lines, usually containing a reference to nature.
Hammer & Nails - "If I had a hammer..." - Peter, Paul and Mary
Hammer & Sickle - An emblem of the Communist movement, now retired... as is the Soviet Union.
Hang Gliding - Trust us. It's a breeze.
Hansel & Gretel - One of Grimm's grimmer fairy tales.
Hard Boiled Eggs - Well, I'll be deviled . . .
Harrison Ford - 1942-, Iconic American actor. "Hokey religions and ancient weapons are no match for a blaster at your side, kid."
Harry Potter - The hero in a series of books by J.K. Rowling featuring muggles and wizards.
Harvard & Yale - "What? Like it's hard?" - Reese Witherspoon Legally Blond
Hawks & Doves - The big birds of war and peace.
Head Lice - Head lice suck blood from the scalp and spread like crazy. A REAL parasite.
Heart & Soul - They're yours. All yours!
Heaven & Hell - The ups and down of the afterlife.
Herb Gardens - Rosemary, Basil, Chive . . . is it a herb garden or the cast from a British drama?
Here & There - And everywhere.
Hills & Valleys - Nature's little ups and down.
Hip Hop - Musical and cultural movement that gained popularity in the 1980s. Yo, yo, yo.
Hit & Run - An automobile crash, or a baseball play.
Hollywood & Vine - The Los Angeles street corner where dreams come true.
Hook & Ladder Trucks - One big reason to become a firefighter.
Hootie & The Blowfish - One of the most commercially successful pop bands to emerge in the 1990s. I go blind when I think about them.
Horse & Cart - Get the order right!
Hospital Gowns - Open all hours.
Hotels & Motels - Get a room!
House & Home - And money pit.
Howard Stern - 1954-, American shock disc jockey. His autobiography is titled Private Parts. If only they WERE private.
Husbands & Wives - For richer... hopefully.
Ice & Snow - "We come from the land of the ice and snow/ From the midnight sun where the hot springs blow." - Led Zeppelin
In The Doghouse - All told, I'd rather be in the cathouse.
Irrational Fears - What's that sound?
Jenna & Barbara - President Bush's daughters, the "First Twins."
John Wayne - 1907-1979, legendary American actor, "The Duke" starred in such classics as Stagecoach, The Sands of Iwo Jima and True Grit.
Johnny Depp - 1963-, American actor and heart-throb. From Cry-Baby to Pirates of the Caribbean - he's as smooth as Chocolat.
Jonah & The Whale - The greatest fish story ever told, in the Bible, that is.
Junkyard Dogs - Not as mean as bad, bad Leroy Brown.
Jurassic Park - 1993 film based on Michael Chrichton's book about dinosaurs brought back to life, with Oscar-winning visual effects.
King Tut - Boy king who ruled Egypt from 1333 to 1323 B.C., known for the great wealth of objects found in his tomb. He took it with him.
Kiss & Tell - Best to keep your mouth shut.
Knife & Fork - Knife on the right, fork on the left.
Knitting Needles - Knit one, pearl two . . .
Lady & The Tramp - The 1955 Disney animated film featuring dogs, love and spaghetti.
Lance Armstrong - 1971-, American cyclist, cancer survivor and winner of the Tour De France - brought new meaning to the phrase "Going Postal."
Lassie - A famous collie, Lassie starred in her own TV show. What's that you say Lassie? Little Timmy's fallen down the well?
Last Night - About last night . . .
Last Will & Testament - It may be your only chance to get the last work on anything.
Laurel & Hardy - Classic fat-skinny comedy duo of the 1920s.
Laverne & Shirley - The 1970s sitcom phenomenon that defined Milwaukee for the world. And Milwaukee's still trying to live it down!
Law & Order - The television show, or the concept.
Leather & Lace - It's a texture thing.
Lemon & Lime - Pucker up.
Lemon Meringue Pie - Tart, sweet and smooth.
Lethal Injection - It's a killer.
Lewis & Clark - The early 1800s expedition covered over 8000 miles and confirmed that the Louisiana Purchase was a very good deal.
Liberty & Justice - For all.
Linguine With Clam Sauce - Pass the parmesan . . .
Lions & Tigers - And bears...
Liposuction - Fatty tissue? That sucks . . .
Liver And Onions - An acquired taste.
Loch Ness Monster - "Nessie," the legendary beast of Loch Ness, Scotland. It must be real, they have pictures.
Lock & Key - Quit picking on me!
Lock & Load - It's off to war we go.
Looney Tunes - Warner Brothers cartoons featuring Porky Pig and Bugs Bunny.
Love & Marriage - First comes love, then comes marriage...
Lox & Bagels - A deli favorite. Pass the cream cheese!
Lucy & Desi - Thirty years later and we still love Lucy.
M & M's - Candy coated chocolates first sold in 1941. Now available in purple.
Macaroni & Cheese - It's the easiest.
Mae West - 1892-1980, American stage and film comedian. "Too much of a good thing can be wonderful."
Maggots - I though it was rice.
Maple Syrup - Made from the sweet sap of the maple tree or black maple tree, produced only in North America - a "must have" for pancakes.
Marlon Brando - 1924-2004, legendary American actor. Starred in A Streetcar Named Desire and won awards for On the Waterfront and The Godfather.
Matzo Balls - Soul for the chicken soup.
Maui - Hawaiian volcanic island, 728 square feet in area. Heaven on Earth.
Maximum Security Prison - When a regular strength prison just won't do.
Me & My Shadow - "Strolling down the avenue..."
Meat & Potatoes - A simpler meal for a simpler time.
Meat Markets - A cut above the rest.
Mensa High IQ Society - Members have IQ's in the top 2% of the population.
Mickey & Minnie - Mouse, that is. Disney's dynamic duo.
Migraine Headaches - Not just any headache.
Milk & Cookies - The ultimate after-school special.
Milwaukee - They don't call their baseball team the "Brewers" for nuthin'.
Minneapolis & St. Paul - The "Twin Cities" are Minnesota's largest population center. They may be twins but you can tell the difference.
Mom & Apple Pie - Worth fighting for.
Mom & Pop - Hey! Maybe they should open a store!
Mom's Cooking - Just like Mom USED to make.
Monitor & The Merrimac - American Civil War ironclads, first fought each other in 1862.
Monkeys - Monkeys see . . .
Moon & The Stars - You want what?
Mount Vesuvius - Italian volcano that rises above the Bay of Naples and blew its top in 79 A.D., much to Pompeii's regret.
Mutual Funds - Mutually benefits you and your broker.
My Father - "Go ask your mother."
My Life - "There are places I'll remember/ All my life, though some have changed." The Beatles
My Memories - Thanks for the memories . . .
My Mother - "Go ask your father."
NASA - National Aeronautics and Space Administration, established in 1958 in part in response to the U.S.S.R. launching Sputnik.
Nashville - Capital of Tennessee and capital of country music - also known as Nash Vegas.
New Yorkers - Brash, brawny and full of bravado.
Nirvana - A state of supreme spiritual bliss and liberation. And then there's the band . . .
North & South Dakota - It's all north.
Nosebleeds - Keep your chin up.
*NSYNC - Popular boy band known for their dance routines and harmonies. Bye, Bye, Bye our albums!
Nuts & Bolts - A good way to stay connected.
Odds & Ends - It's in the junk drawer.
Oil & Filter - Let me top that off for you.
Oil & Vinegar - They don't mix, but we keep trying.
Old Age - It looks good when you consider the alternative.
Ordinary People - Nothing special.
Pail & Shovel - I can dig it.
Panning For Gold - The dot-coms of the 1840s . . .
Paul McCartney & Wings - Life after The Beatles.
Peace & Love - Flower Power!
Peace & Quiet - Truly appreciated during parenthood.
Peaches & Cream - A great complexion and a great dessert.
Peanut Butter & Jelly - On white bread; cut off the crusts.
Peanuts & Popcorn - It's a crackerjack combination!
Pebbles & Bamm-Bamm - The cartoon kids from The Flintstones. BAM-BAM, BAM-BAM, BAM-BAM.
Pencil & Paper - We're drawn to them!
Penn & Teller - Magicians, illusionists, entertainers, and comedians.
Pez Dispensers - Collectable candy dispensers first being sold in 1952. Believe it or not, there has never been an Elvis Pez dispenser.
Phone & Fax - Soon you won't need to leave the house at all!
Pineapple - Tropical fruit, or the less lush hand grenade.
Pink Flamingos - Gracing America's lawns for more than 40 years - sold only in pairs.
Pins & Needles - It's all sewed up!
Playing Golf - For stress reduction. Now, get that head down and straighten your arm!
Pole Vaulting - The sport where you can reach new heights.
Pomp & Circumstance - La-de-da.
Porcupines - Quill-bearing rodents that can leave you in a prickly situation.
Pork & Beans - Rustle us up some grub, Cookie.
Power & Glory - The spoils of war.
President Bush - 1946-, 43rd president of the United States.
Pride & Prejudice - Jane Austin's 1813 classic novel expounding on the consequences of pride.
Queen Elizabeth II - 1926-, Queen of the United Kingdom and Northern Ireland since 1952. Shame about the kids, though . . .
R & B - Rhythm and Blues.
R & D - Research and Development.
R & R - Rest and relaxation, recreation or could be recuperation.
Raves - Neo-psychedelic all-night dance parties centered around acid, house, and techno music. All the rave.
Reading & Writing - Old-fashioned skill, amazingly still useful today.
Regis & ... - Kathy Lee or Kelly - your choice.
Rice & Beans - The south-of-the-border meat and potatoes.
Rice Krispies Treats - How could you go wrong with Rice Krispies, marshmallows, and butter.
Richard Simmons - 1948-, American fitness guru famous for his extroverted style, short shorts and Sweatin' to the Oldies.
Rio De Janeiro - Vibrant Brazilian city and home to Carnival. Blame it on Rio!
Road Rage - Ten years ago we complained about potholes. NOW we're dodging pot-shots.
Robin Hood - Legendary British outlaw who stole from the rich and gave to the poor, known for his courage, skill, and Merry Men.
Rock & Roll - It'll never die. Unlike Rock and Roll musicians.
Rod & Reel - He took it hook, line, and sinker.
Rogers & Hammerstein - Kings of the Broadway Musical: The Sound of Music, The King and I, South Pacific, and many, many more.
Rope Burns - You were playing WHAT?
Rusty Nails - Good name for a country western singer.
Salt 'N Pepa - Extremely successful rap group formed in the 1980s, known for their portrayals of the woman's perspective on relationships.
Salt & Pepper - "Pump it up a notch! BAM!" - Emeril Lagasse.
Sand & Surf - Life's a beach!
Sandra Bullock - 1964-, American actor who starred in Speed, Miss Congeniality, and While You Were Sleeping. The classic girl-next-door.
Scented Candles - You didn't have to BAKE an apple pie - just light a candle.
Shake & Bake - ... and eat.
Shave & A Haircut - Two bits.
Shipwrecks - "The lake it is said never gives up her dead . . ." - The Wreck of the Edmund Fitzgerald"
Sigmund Freud - 1856-1939, Viennese psychologist and the originator of psychoanalysis and the Freudian slip.
Sin & Redemption - Everybody deserves a second chance.
Sitcoms - If they're so funny, WHY THE LAUGH TRACK?
Skin & Bones - What would you be without them?
Slash & Burn - And there goes another rain forest...
Slasher Films - A real nightmare.
Slice & Dice - A sharp knife is a safe knife.
Slip & Fall - Watch out for ... too late!
Slobodan Milosevic - 1941-, former leader of Serbia, also known as "the Butcher of the Balkans."
Smith & Wesson - Firearms when ready!
Smoke & Mirrors - That's how we do it!
Snips & Snails - And puppy dog tails.
Snoopy & The Red Barron - Characters in the Peanuts comic strip. Talk about a dog fight!
Space & Time - Infinite.
Spiders & Snakes - Creepy! Legs or no legs.
Spit & Polish - We could do with less spit and more polish.
Stalactites & Stalagmites - The ups and downs of spelunking.
Stamp Collecting - If you can't lick 'em, collect 'em.
Stanley & Livingston - Britons who explored Africa, I presume.
Stars & Stripes - Three cheers for the red, white, and blue!
Sticks & Stones - When words are not enough.
Stocks & Bonds - At least they're worth the paper they're printed on... We hope.
Stop Signs - Gee, Officer, I THOUGHT it was green!
Strained Peas - The strain comes when you have to eat them.
Street Mimes - A mime is a terrible thing to waste. On second thought . . .
Stretch Limos - Stretch your legs, stretch your wallet.
Strip Malls - Almost as attractive as stip mines.
Sugar & Spice - And everything nice.
Suit & Tie - It's business as usual!
Sumo Wrestlers - Wrestlers usually weigh 300-400 pounds and win this Japanese form of wrestling by forcing an opponent out of the ring.
Surf & Turf - Steak and lobster. No need to choose.
Surprise Parties - SURPRISE! Oh. He had a heart condition . . . that WAS a surprise . . .
Tarred & Feathered - It's a sticky situation.
Tarzan & Jane - He went ape over her.
Tattoo Parlors - "With nothing to show but this brand new tattoo . . . how I got it here I haven't a clue." - Jimmy Buffett
Tea & Crumpets - Upper-crust toast & jelly.
The 1990s - Dot-coms, Clinton and designer coffee. The good old days.
The Atlantic & Pacific - Oceans apart.
The Big Dipper - Group of stars in the Northern sky that form part of the constellation Ursa Major.
The Birds & The Bees - We'll tell you about them sometime.
The Chicken & The Egg - Which came first? The egg. Look it up!
The Dalai Lama - Title of the leader of Tibetan Buddhism, in exile since 1959. Hello, Dalai!
The Dixie Chicks - Female country and western band with pop leanings. Winners of multiple Country Music Association awards. Goodbye, Earl!
The Graveyard Shift - It WILL be the death of me . . .
The Great Barrier Reef - Coral reefs, shoals and islets off the northern coast of Australia. Scuba heaven.
The Great Wall Of China - A 1500 mile long wall across northern China. Built for fortification but better for tourism.
The Ice Age - Polarity analysis of deep-sea sediment suggests the Pleistocene age began more than 1.8 million years ago. Bla-bla-bla.
The Judge - Smile when you play this card.
The Mounties - The Royal Canadian Mounted Police. They always get their man.
The North Pole - Things can only go south from here . . .
The Princess & The Pea - The true test of a princess, fairy tale or otherwise.
The Scarlet Letter - Hawthorne's 1845 novel about Puritan New England, moral conflicts, guilt, and down-right nastiness. (It was an "A".)
The Symphony - It's music to our ears.
The Three Stooges - Nyuk, nyuk, nyuk. A wiseguy, eh?
The U.S. Constitution - We the people . . .
The Young & The Restless - Launched in 1973, this soap opera isn't young, but it's still restless.
Thelma & Louise - 1991 Ridley Scott film starring Susan Sarandon and Geena Davis as two over-the-edge women.
Three Men & A Baby - The 1987 comedy film. You do the math.
Thunder & Lightning - Nature's fireworks.
Timbuktu - City of 20,000 located in the West African nation of Mali. The official name if Tombouctou. From here to Timbuktu.
Time Travel - "What do you mean I missed my connection in the 14th Century?"
Timothy McVey - 1961-2001, the Oklahoma City Bomber.
Tom & Jerry - A good chaser.
Tony Blair - 1951-, British Prime Minister, "We will not rest until this evil is driven from our world." Sept. 11, 2001.
Track & Field - It's eventful.
Tractors - "She thinks My Tractor's Sexy." - Kenny Chesney
Treasure Hunting - Gold Doubloons! Gold Doubloons! AT A YARD SALE?
Trekkies - Beam them up, PLEASE!
Trinidad & Tobago - Tiny, lush Caribbean republic. One of the most prosperous countries in the area due to petroleum and natural gas production.
Truth & Justice - Sounds good on paper.
Turkey & Stuffing - Get stuffed.
Tyra Banks - 1973-, American model, starred in Coyote Ugly. Probably the only time you'll see the words "ugly" and "Tyra Banks" in the same sentence.
Umbrella Drinks - Extra fruit, please!
Urban Sprawl - Oh give me a home where the edge of town roams . . .
Velcro - A hook-and-loop fastener that can really grab you.
Venus & Mars - As different as men & women.
Viagra - It works for Bob Dole and 16 million others, it'll work for you.
Volcanoes - Vents in the crust of the earth from which steam, debris and molten rock spew, with explosive results.
War & Peace - Tolstoy's 1805 epic novel of the Napoleonic wars, a celebration of Russian spirit.
Washer & Dryer - Take them out for a spin.
Waxing The Floor - It's a pain in the neck, and back, and knees . . .
Weed & Feed - Make sure the grass is greener on YOUR side of the fence.
Weird Al Yankovic - 1959-, American musical humorist, born Alfred Matthew Yankovic, which is nothing to laugh about . . .
Whips & Chains - Popular before prison reform - the good old days.
White Collar Crime - Three strikes and you're OUT . . . to a cozy little low-level detention facility with a pool and tennis court.
Will & Grace - Popular sitcom debuted in 1998. Not your average next door neighbors.
Working Out - No pain, no gain.
Xena, Warrior Princess - Popular TV fantasy, adventure program. Xena, played by Lucy Lawless, and her friend Gabrielle, seek adventure and fight evil.
Yin & Yang - Two elements that oppose each other and give life balance. If you're lucky.
Zippers - Zip it, zip it good.
Zombies - Undead ghouls that feed off of brains. So WE'RE safe . . .
4-H Clubs - Head, Heart, Hands and Health. A youth organization promoting leadership, citizenship, and life skills. See you at the fair!
A Blackberry - It's a fruit and an integrated communications system!
A Blind Date - I can't see much future in it.
A Broken Nose - It adds character!
A Comb-Over - The world's worst cover-up.
A Damsel In Distress - Where's that knight in shining armor?
A French Bakery - Baguettes, croissants or a nice Gateau St. Honore? Just don't ask for French Toast.
A Galaxy - A galaxy can range from 1,500 to 300,000 light-years. It's enough to make your head spin
A Genie - Most grant three wishes...and then head for the bottle.
A Good Education - Found at school... or at home.
A Midnight Snack - Pizza, chips, cereal, ice cream...
A Miracle - It's going to take a miracle...
A One-Horse Town - Half the size of a two-horse town.
A Pool Boy - Keeping it clean!
A Rump Roast - The meat of Meat and Potatoes."
Acne - It's not funny - is zit?
Action Figures - Batteries not included- or needed.
Acupuncture - This traditional Chinese practice will have you on pins and needles.
Airplane Restrooms - Small, cramped and smelly - but they're lining up to get in!
Alaskan Pipeline - At 800 miles long and 48" in diameter, this is one of the largest pipeline systems in the world Cold and crude.
Alcoholism - The compulsive consumption and dependence on alcoholic beverages.
Alimony - What was for richer is now for poorer.
Almond Joy - "Sometimes you feel like a nut..."
Aluminum Siding - Encase your house in metal - sheer genius!
American Beauty - It's a classic-the rose, the movie, the woman, or the automobile.
American Idol - FOX network's reality program based on a talent competition for 16-28 year-olds. No visible tattoos allowed.
An Autopsy - On the plus side, it's the last physical you'll ever have to take.
Anarchy - Who's in charge here?
Angelina Jolie - 1975-, American actor in Gone in Sixty Seconds and Lara Croft: Tomb Raider. She won an Academy Award for Girl, Interrupted.
Angels - "Teacher says every time a bell rings, an angel gets his wings." - Zuzu Baily It's a Wonderful Life
Appalachians - Get your fiddle and I'll bring the banjo. There'll be music in the mountains tonight!
Aretha Franklin - 1942-, American rock and roll, blues, and gospel singer. The Queen of Soul deserves
Avalanches - Nearly all avalanches that involve people are triggered by the victims themselves. So walk softly and carry a cell phone.
Baghdad - The capital of Iraq. This city was founded in 764 A.D. and called Madinat as-Salam which means "City of Peace."
Barbra Streisand - 1942- , American singer, actor, director, and producer. The first ever to win a Grammy, Emmy, Oscar and a Tony. A star WAS born!
Bette Midler - 1945-, American actor and popular singer. From the New York bathhouses to the "Divine Miss M."
Big Bellies - Often found on chubby hubbies...
Bill Cosby - 1937-, American actor and comedian who starred in I Spy, The Cosby Show, and created Fat Albert. Hey, hey, hey-he's got a PhD!
Bird Flu - Bird flu is caused by avian influenza viruses. It is highly contagious among birds and has the potential to adapt and spread among humans.
Black Eyed Peas - Good listening and good eating!
Black Widows - Large venomous spiders in the American southwest. The male is half the size of the female, and very nervous...
Blackmail - I know what you did last summer...
Boa Constrictor - Found in the Central and South America, this snake can reach 13 feet in length. Want a hug?
Book Clubs - It doesn't matter if the book is good, as long as there's dessert.
Boomerangs - They're due for a comeback!
Boston Strangler - Between 1962 and 1964, Albert DiSalvo assaulted and murdered eleven single women in their Boston apartment.
Boston Tea Party - On December 16, 1773, American patriots boarded ships in the Boston harbor and emptied 342 chests of tea in protest of British taxation.
Botox - A few shots and you'll have no worries for six months - or at least you'll look that way.
Bowling Balls - In 1963 alone, Americans spent over $43 million on bowling balls. The bowling industry was on a roll.
Box Cutters - Take one on a plane and they'll cut you off the passenger list.
Boys Night Out - Nothing, Honey, just played some card...
Breast Implants - A growing industry.
Broccoli - Fighting cancer for over 2,000 years.
Bruce Lee - 1940-1973, American icon of martial arts films. This kung fu master influenced martial arts worldwide. Enter the Dragon.
Budapest - Capital of Hungary. This city of almost 2 million is divided into two parts - the hilly Buda and the flat Pest.
Buffalo Soldiers - African American U.S. army units who fought in the Indian Wars and explored vast areas of the southwest.
Bulging Biceps - My, what big muscles you have...
Burger King - 11,000 restaurants serving flame-broiled burgers worldwide. Have it Your Way.
Butter - I can't believe it's not margarine!
Cabin In The Woods - Relaxing...unless that guy in the hockey mask shows up.
Calculus - How do I calculate my level of confusion in calculus class?
Cameron Diaz - 1972-, American actor in Gangs of New York, and one of Charlie's new angels. There's something about Cameron.
Cannibals - We must have you for dinner sometime!
Car Insurance - Don't leave home without it!
Carrots - The root of all carrot cakes.
Cashmere Sweaters - They should be called CashMORE sweaters!
Caterpillars - Bugs or bulldozers. There's gonna be some changes 'round here.
Central Park - Each year, over 25 million people visit these 843 acres of beautiful lawns and woodlands located in Manhattan.
Champagne - Salud! ... Le chaim! ... Cheers! ... Slinte! ...
Chaps - Used to be just for cowboys...
Chick Flicks - Steel Magnolias, Beaches, Waiting To Exhale... Ratings: **** ...and fifteen tissues.
Chicken Dance - Da, da, da...
Chicken Feed - You can't get it for chicken feed.
Chicken, Alaska - Take the Klondike loop from Whitehorse to Dawson City and you're almost there. Get the cluck over here!
Chicks - Fine feathered friends...
Christopher Reeve - 1952-2004, American actor, director, author, activist and chairman of the Christopher Reeve Paralysis Foundation. A real Superman.
Christopher Walken - 1943-, American actor and winner of an Academy Award for The Deer Hunter. He makes "mentally unbalanced" look so natural.
Cigars - Power smoking.
Cinnamon Toast - Sugar and spice and everything nice.
Cleveland Indians - This Cleveland baseball team took the name "Indians" in 1915. It's the tribe
Clinical Depression - Clinical or not - it's depressing.
Coastal Erosion - Wasn't California here just a minute ago...
Cockpit Recordings - If those black boxes are so indestructible, why not make the whole plane out of them?
Cocktail Parties - Shake and serve straight up. It's a drinking game!
Conservatives - To the right of the political spectrum.
Corsets - From whalebones to latex...still in fashion.
Cowboy Boots - These boots were made for two-steppin'.
Cowgirls - "Even cowgirls get the blues." -Tom Robbins
Cream Puffs - A real lightweight... unless you're counting calories.
Cream Rinse - Perfect after a milk bath.
Credit Cards - For everything else there's CASH.
Crisis Centers - Please leave a message at the sound of the beep...
Crop Circles - Worldwide, more than 10,000 crop circles have been reported. No crop squares, to date.
Cross Dressing - A personal statement... or a fashion statement.
Cucumbers - A little brine and they're in a pickle.
Dallas, Texas - The largest city in Texas. The big D.
Danny Glover - 1946-, American actor who was appointed goodwill ambassador for the United Nations Development Program. Lethal box office weapon.
Desperate Housewives - A prime-time soap opera featuring the lives of five suburban housewives. Apparently, millions are desperate to watch...
Diane Keaton - 1946-, American actor, known for her personal style and award winning acting in Annie Hall, Marvin's Room, and Something's Gotta Give.
Diet Pills - Results may vary.
Dirty Dancing - Now legal in most states.
DNA Testing - I had my DNA tested. It failed.
Domestic Partners - Not exactly married, not exactly dating.
Don King - 1932-, American boxing promoter. He has donated millions to worthy causes, but is better known for his knock-out hair.
Donald Trump - 1946-, American success story. Chairman of The Trump Organization for real estate development. If he says you're fired, you're fired!
Doomsday - I reckon it will come.
Down Comforters - Just ducky when the cold weather gets your goose.
Dr. Phil - Psychologist Dr. Phil McGraw helps millions "get real" on his TV show... Life Law #1: Either you get it or you don't.
Dreams - "If you can dream it, you can do it." - Walt Disney
Drive-In Movies - The entertainment's not just on the screen.
Drooling - What a drip!
Duck Decoys - A bunch of quacks!
Duckbill Platypus - A furry, egg-laying animal with webbed forefeet. It's a bird...no, it's a reptile, no, it's a mammal ...actually, it's a marsupial.
EBay - "The World's Online Marketplace." The bazaar for the bizarre.
Egg Rolls - Tasty Chinese appetizers. We're not sure where the egg comes in...
Elvis Impersonators - Will the real Elvis please stand up?
Emeril LaGasse - 1959-, chef, restauranteur and television personality, known for New Orleans regional specialties. BAM!
Empire State Building - The static electricity buildup on the top of the building is so great that kissing can actually create sparks!
Energizer Bunny - The pink, drum beating "Spokes Hare" for Energizer batteries. It keeps annoying... and annoying...and annoying...
Engineers - They have designs on your future...
Enron - They manipulated the books, stocks plummeted, people lost their jobs and a couple of guys went to jail.
Evolution - Charles Darwin's observations of the variations among plants and animals on the Galapagos Islands led to his theory of evolution.
Exchange Students - You can only exchange them if you've got the receipt.
Facial Hair - Good news for teenage boys. Bad news for middle-aged women.
Factory Work - Everyday working shifts...
Fangs - Take a bite out of life... someone else's, that is.
Farm Animals - "Four legs good, two legs bad." -George Orwell Animal Farm
Father's Day - Traditionally, more collect calls are made on Father's Day than any other day of the year.
FEMA - Federal Emergency Management Agency, responsible for disaster mitigation, preparedness, response and recovery.
Fight Club - 1999 film starring Brad Pitt and Edward Norton. Don't talk about Fight Club.
Fire Ants - A hot topic in the extermination business.
Fire Hydrants - The fire hydrant was invented by Birdsill Holly in 1869. Holly held over 150 U.S. patents, second only to Edison.
Fire-Eaters - A hot career move...
Fireside Chats - From stories around the campfire, to Franklin D. Roosevelt's popular 1930s and 1940s radio addresses - they'll warm your heart.
First Born - All the attention and no hand-me-downs.
Fjords - Long narrow inlets from the sea between steep cliffs.
Flannel Sheets - Some nights call for satin sheets, and some for flannel.
Florida - Over one thousand miles of beaches to enjoy ...if the sharks don't get you.
Flounders - Bottom-feeding flatfish. Things gotta be looking up.
Flying Saucers - On July 8, 1947 the U.S. Army reported that flying saucer wreckage was discovered near Roswell, NM. (Statement retracted on July 9.)
Flying Solo - You're on your own!
Foam Rubber - Foam rubber is a biodegradable matter produced from rubber trees. That'd be a cushy job.
Focus Groups - We need to run this card past a few dozen people first...
Fondue - The taste says fondue...the calories say fonDON'T...
Foreign Films - How do they expect you to watch the film when you gotta read the subtitles?
Four-Inch Heels - Better to start with one-inch and work your way up.
France - Not just a country- it's a state of mind!
Fraternities - An organization of male college students. Toga! Toga! Toga!
Free Clinics - Hey, the disease was free, the clinic should be too!
Frogmen - What do you get if you kiss a frogman?
Galactic Noise - The radio-frequency radiation originating outside the solar system. Is it just us, or is there somebody else out there?
Game Sanctuaries - Protection for game players everywhere.
Garage Sales - Tag sales, yard sales, rummage sales - take your pick, just get there early!
Garlic - The flavor that lasts, and last, and lasts...
Gas Prices - What goes up, must...go up again!
Gen. Douglas MacArthur - 1880-1964, the most decorated soldier in the history of the U.S. military. MacArthur took part in WWI, WWII and the Korean War.
Gentlemen - They prefer blondes... brunettes...redheads...
Geronimo - 1829-1909, Apache leader known for his wisdom and courage. He died as a prisoner of war at Fort Sill in Oklahoma.
Getting A Raise - Asking for one gets a raise ... out of your boss.
Girls Night Out - Don't worry, Honey, it's just shopping and dinner.
Gladiators - Although most of the Roman gladiators were slaves, they were well-fed and given expert medical care.
Going Bald - "Bald Is Beautiful!" -BHMA (Bald-Headed Men of America)
Graham Crackers - Developed in 1829, by Sylvester Graham, for the health benefits. He also promoted hard mattresses and cold showers.
Granite - You can take it for granite.
Grass Huts - People who live in grass huts shouldn't throw matches.
Graveyards - Finally, a real resting place.
Gravy - No lumps? Good gravy!
Grease Monkeys - The boys under the hood.
Greece - Lofty mountains, blue seas and 8,000 miles of coastline. I'll take the spanakopita with calamari on the side! OPA!
Green Acres - It's the place to be...
Greenhouse Effect - Without any greenhouse effect the earth would not be warm enough to sustain life.
Grilled Cheese - Cooking School 101.
Ground Zero - A blast area or the target of a missile or bomb.
Group Therapy - Being analyzed with a group of strangers? And how does that make you feel?
Halftime Shows - From marching bands to "wardrobe malfunctions."
Hamburgers - The all-American sandwich named after a city in Germany.
Hardware Stores - I need a thingy to put on the what-cha-ma-call-it...
Hash - "There is nothing worse for the health, or the palate, than a poor hash." -Miss Beecher's Domestic Receipt Book, 1846
Hitchhikers - Going my way?
Home Alone - Kids like it. Parents love it!
Home Run - Get up...get up...get outta here...GONE! -Bob Uecker
Hospitals - The nation's first hospital, opened in the 1750s, was established for the "sick, poor and insane" in Philadelphia.
Hostages - It looks like we'll be tied up for awhile!"
Hot Tub Parties - Warning: the use of drugs or alcohol before or during spa use could lead to unconsciousness.
Hugh Grant - 1960-, British actor of numerous romantic comedies including Four Weddings and a Funeral, Notting Hill, and About a Boy.
Hugh Hefner - 1926-, founded Playboy magazine in 1953 and went on to build an empire based on celebrating sex.
Hula-Hoops - The fad that keeps going round and around.
Hummers - Combat carrier turned kid carrier.
Hurricane Katrina - Katrina made landfall in August of 2005, and caused major damage to the coastal regions of Louisiana, Mississippi and Alabama.
Husbands - "When a husband brings his wife flowers for no reason, there's a reason." -Molly McGee
Idaho - Scenic beauty, rugged wilderness, and more than enough potatoes.
Identity Crisis - Who? Me?
Identity Theft - What if nobody wants your identity?
Illegal Aliens - International or interplanetary.
Income Tax - Nothing "in-coming" about it.
Inflation - Back in my day, mansions used to cost a nickel. A NICKEL!
Injustice - It's just not fair.
Intelligent Design - The name given to the concept that the universe, and all living things, are a result of an intelligent creator.
International Spies - Cool gadgets.
Internet Dating - Turn-ones: candlelight dinners and walks on the beach. Turn-offs: the computer crashing...
Iraq - Iraq attained its independence in 1932 and was declared a republic in 1958. Population: 26 million
Irish Setters - High-energy bird dog known for its silky red coat and playful personality. Erin go woof.
Iron Chef - Japanese television program. World-class chefs compete to create 3-course meals. Galloping Gourmet meets World Wrestling Federation.
Island Retreat - Look, Honey, The Island of Dr. Moreau, doesn't that sound nice?...
Jail - Do not pass Go. Do not collect $200.
James Woods - 1947-, American actor nominated for Academy Awards for Ghosts of Mississippi and Salvador. He dropped out of M.I.T. to pursue acting.
Jane Fonda - 1937-, American actor who made 40 films and won Academy Awards for Klute and Coming Home. A.k.a. Hanoi Jane.
Janet Jackson - 1966-, American singer, composer and actor. Early in her career she played Penny on Good Times and Charlene on Diff'rent Strokes.
Jennifer Anistor - 1969-, American film and television actress, best known for the highly successful comedy series, Friends.
Jet Lag - Some travel experts estimate that it takes a day of recovery for each time zone passed.
John Doe - Who?
Jahn Malkovich - 1953-, American movie actor and director. Known for In the Line of Fire, Places in the Heart and, of course, Being John Malkovich.
Jugglers - They've got their hands full.
Julia Child - 1912-2004, American chef, author and television personality. She popularized French cooking in the United States. Bon Appetit!
Justin Timberlake - 1981-, American singer whose career began on Star Search at age 11, then on to The Mickey Mouse Club, and 'N Sync. Curly Spice!
Karaoke - Sing...sing a song... sing it badly, to last your whole life long...
Kentucky - Bordering seven states, Kentucky is known for horses, mountains and bourbon. Not a bad combination.
Kevin Bacon - 1958-, American actor of Mystic River, A Few Good Men, The River Wild and JFK. Footloose from the start...
Kevin Costner - 1955-, American actor and director who starred in JFK and Field of Dreams. His Dances With Wolves won an Academy Award for Best Picture.
Knights In Shining Armor - "You're my knight in shining armor. Don't you forget it." - Ethel Thayer On Golden Pond
Krispy Kreme - Making doughnuts since 1937. If the light's on you'll get hot doughnuts. HOT NOW!
Labor Pains - Don't push me!
Lap dogs - Portable pooches.
Larry King - 1933-, television talk show host. He began broadcasting in 1957 and 40,000 interviews later, he's considered "Master of the Mike."
Lavender - Hearty shrub with spikes of small purple flowers which smell just like...lavender.
Law School - "You got into Harvard Law?" "What? Like, it's hard?" - Elle Woods Legally Blonde
Leaky Faucets - Your own personal water torture.
Learning Latin - I came, I saw, I flunked.
Lemmings - Native to Scandinavia, lemmings have round furry bodies, short legs, and small eyes...and a loyal following!
Lethal Weapons - Too many kinds to list...
Lettuce - Two heads are better than one!
Liberals - To the left of the political spectrum.
Librarians - "How to make an atomic bomb? No problem, we have a book on that."
Lima Beans - Lima beans have been cultivated in Peru since 6000 B.C. - that's a whole lotta limas.
Limosines - Stretch out and enjoy the ride.
Live Bait - GONE FISHIN'
Long Division - That's why calculators were invented.
Losing Your Luggage - If only your luggage got frequent flyer miles.
Lowriders - The modified suspension decreases ground clearance on these customized vehicles. East L.A. to New York to Japan...they're hoppin'.
Lumberjack - "I'm a lumberjack and I'm okay..." - Monty Python
Luncheon Meat - What a bunch of baloney!
M. C. Escher - 1898-1972, Dutch artist known for his "impossible structures" including Ascending and Descending. I can't tell if he's coming or going!
Magicians - Now you see 'em... now you see 'em again.
Magnetic Fields - Strangely attractive!
Malcolm X - 1925-65, American civil rights leader, was assassinated on the first day of National Brotherhood Week.
Mammoth Cave - The longest recorded cave system in the world, over 360 mapped miles. Stay with your group...
Married Men - Statistics show that married men live longer, healthier, happier, and wealthier lives. Of course, there are exceptions.
Mayonnaise - In 1905, Richard Hellman, a German immigrant, opened a delicatessen selling salads made with his wife's mayonnaise.
Medicinal Plants - For medical use only.
Meteorologists - They're so predictable...
Miami Beach - So hot and yet so cool.
Michael Moore - 1954-, American documentary film maker of Roger and Me and Fahrenheit 9/11 He won an Academy Award for Bowling for Columbine.
Mimes - [No words, just two four-fingered gloves.]
Mint Jelly - Good with lamb... and that's about it.
Mistletoe - The Druids believe that mistletoe could improve fertility...so be careful who you kiss.
Model Prisoner - He made the BEST license plates.
Mona Lisa - Leonardo da Vinci's painting of the most famous smile in the world.
Mondays - "Monday, Monday, can't trust that day..." - The Mamas and the Papas
Monopoly - The longest game of Monopoly ever played lasted 1,680 hours.
Morgan Freeman - 1937-, American actor who won Academy Awards for Million Dollar Baby and Driving Miss Daisy. He's Street Smart and much more.
Mother's Day - Oh, honey...you made... it...all by yourself...
Mu Shu Pork - Pancakes - Chinese style.
Mushrooms - Nobody knows the truffles I've seen...
My Blue Jeans - When I wake up in the mornin' light, I pull on my jeans and I feel all right." - Keith Urban
My Car - My other car is a beater too.
My Dad's Car - "Oh, man, he's going to kill me!"
My Inheritance - It's all in the family...
My Obituary - "The report of my death was an exaggeration.: - Mark Twain
My Sweetheart - "No, I love YOU more!" "No, I love YOU more!"
Nachos - "Nacho, nacho man. I want to be a nacho man,: - Homer Simpson
Napoleon Dynamite - 2004 upbeat comedy film starring Jon Heder as an alienated teenager in a small western high school. Gosh!
National Debt - We'll let our kids worry about that...
Nebraska - Famous Nebraskans: Willa Cather, Crazy Horse, Fred Astaire, and Marlon Brando.
Nelson Mandela - 1918-, South African, awarded the 1993 Nobel Peace Prize for his leadership in the peaceful termination of apartheid.
New Year's Resolution - This year's going to be different...
New York Times - "The grey lady" was one of the last newspapers to adopt color photography. Seems like they were a bit behind the times...
Nicole Kidman - 1967-, actor, American born but raised in Australia. She won Academy Awards for The Hours and Moulin Rouge.
Norway Spruce - This fast-growing conifer is native to central and northern Europe and quickly reaches 80 feet in \height.
Notre Dame Football - Not just football-it's Notre Dame Football! WE-ARE-N-D, GO-IRISH!
Nurses - "After two days in the hospital I took a turn for the nurse." - W. C. Fields
Oklahoma City Bombing - On April 19, 1995 a massive explosion was set off, destroying a federal building, killing 168 people, and injuring 850 others.
Oktoberfest - Lace up your lederhosen and roll out the barrel!
Optic Nerves - You're getting on your optic nerves, man!
Orlando, Florida - Cypress Gardens, Universal Studios, Sea World and Disney World. Something for everyone- everyone who likes theme parks, that is.
Owen Wilson - 1968-, American actor, appeared in Rushmore, The Royal Tenenbaums and Wedding Crashers. He's a self-proclaimed trouble-maker.
Owning Land - "Why, land is the only thing in the world worth workin' for, worth fightin' for, worth dyin' for..." - Gerald O'Hara Gone with the Wind
Pamela Anderson - 1967-, Canadian actor. From Home Improvement to Baywatch and Stripperella, with five Playboy covers along the way.
Paper Shredders - What bill from Tiffany's? I didn't see any bill from Tiffany's...
Parachutes - Golden or otherwise...
Paradise - "They paved paradise and put up a parking lot." - Joni Mitchell
Paranoid - I don't trust them!
Paris Hilton - 1981-, American model, actor and TV personality. We'll always have Paris.
Park Rangers - "What pic-a-nic basket, Ranger Smith?" - Yogi Bear
Patriot Act - Public Law No. 107-56, introduced in 2001. "To deter and punish terrorist acts in the U.S. and around the world..."
Penthouse Apartment - A deluxe apartment in the sky! - The Jeffersons
Phantom Limb - The sensation that an amputated limb is still there. Also known as "stump hallucination."
Pie Charts - For people with an appetite for numbers...
Ping-Pong - The game was first played with a rubber ball (too fast), then a cork ball (too slow), and then a celluloid ball (just right).
Pneumonia - Serious inflammation of the lung caused by bacteria or a virus.
Pockets - Pick one!
Political Debates - They ARE political- the rest is debatable.
Pomegranates - The size of an apple, this fruit is covered with a dark red, leathery rind. The seeds and juice are the only edible parts.
Ponchos - They're totally armless!
Poverty - Who won the war on poverty, anyway?
Prescription Drugs - WARNING: Do not operate heavy machinery...
Prickly Pears - Type of cactus with flat, oval pads and large spikes.
Primrose Path - Come on down!
Private Schools - An expensive lesson.
Puerto Rico - As a territory of the United States, Puerto Rico's 4 million people have their own constitution and their own Olympic team.
Puppet Shows - Just pull a few strings...
Pussy Willows - A type of willow tree distinguished, in the spring, by silky, grey catkins.
Pythons - I'll name mine Monty!
Radishes - The root of a good salad.
Rain Forests - Endangered ecosystems, or trendy cafs.
Rare Coins - One old coin can cost several thousand new ones.
Ray Charles - 1930-2004, American singer and songwriter of Jazz, Rhythm & Blues, and Rock & Roll. Awarded the National Medal of Arts in 1993.
Razorbacks - A 250 pound wild boar, or the University of Arkansas athletic teams. "Time to call in the pigs. Woo...Pig...Sooiee!"
Reality - It's overrated!
Red Peppers - You'll warm up to 'em...
Rene Zellweger - 1969-, American actor, starred in Bridget Jones's Diary, and Chicago, and won an Oscar for her portrayal of Ruby in Cold Mountain.
Retirement - Youth may be wasted on the young but retirement is wasted on the old.
Richard Gere - 1949-, American actor. He's been an American Gigolo and An Officer and a Gentleman and sang and danced his way through Chicago.
Ring-Necked Pheasants - The male is easily identified by the distinct green head, red facial skin, white neck ring, and long golden tail feathers. All dressed up...
Risky Business - Risky business is risky business except when it's a sure thing like the 1983 film starring a young Tom Cruise.
Road Maps - You have to know when to hold 'em and when to fold 'em...
Roadies - ...check...check... testing...check... check...
Roadside Cafs - You want pie? We got pie.
Robert Redford - 1937-, American movie man. Produced 23 films, directed 7, acted in 39, and supports emerging film makers through the Sundance Institute.
Rogaine - A non-prescription formula developer to help regrow hair. Hair today, hair tomorrow.
Saber-Tooth Tigers - Now extinct, the saber-tooth tiger used large canine teeth to rip into the throat or belly of it's prey. It's the California State Fossil.
Safety Pins - For diapers. Or punks. Or old punks' diapers.
Sand Dollars - Members of the class of marine animals known as echinoids. Save enough and you can buy a sand castle.
Sand Dunes - The are five basic dune shapes: linear, dome, crescent, star and parabola.
Saturday Night Live - The award-winning comedy show featuring top musical performances and guest hosts. "Live from New York..."
Sauerkraut - Cabbage, salt and the magic of fermentation...
Saunas - Just sweat it out...!
School Prayer - Please, God, let me pass this test...
School Uniforms - You might not be smarter but you'll look smarter...
Scientific Knowledge - Prove it!
Scorpions - The big sting!
Segregation - The discriminatory policy, or practice, of imposing the separation of people based on race.
September 11 - The date in 2001 when terrorists attacked the U.S. by flying hijacked jetliners into the World Trade Center and the Pentagon.
Sermons - I think he was talking to you...
Sex And The City - The critically acclaimed HBO television series based on the lives of four single women in New York City...and sex.
Sharon Stone - 1958-, American actor known for her portrayal of smart and aggressive characters in such films as Casino and Basic Instinct.
Sheep - What do sheep count when THEY can't sleep?
Sherwood Forest - At one time, Sherwood Forest was the largest of England's royal forests. Legendary home of Robin Hood and his Merry Men (in tights).
Shoplifting - The gateway to a life of crime.
Shrek - The Academy Award winning 2001 animated film featuring an ogre and a donkey rescuing a princess.
Silicon Valley - Great place to live... they're all virus protected.
Single Women - Girls just want to have fun!
Sleep - "I have never taken any exercise except sleeping and resting." - Mark Twain
Slot Machines - Think you'll win? The they're pulling YOUR arm...
Snoop Dogg - 1971-, American popular gangsta-rapper known for his distinctive style, as well as his albums, soundtracks, and TV and film appearances.
Social Workers - Going down to the water cooler doesn't make you a social worker.
Sockeye Salmon - Found in the Pacific and Arctic oceans, the sockeye salmon can be identified by the distinct gill rakers, or the sublime tarragon sauce.
Sororities - Organizations of female college students. Sisters to the end...or at least until graduation.
Soul Mate - Even soul mates won't put up with some things.
Spending Money - But it was on sale...
Spider-Man - Peter Parker, a young orphan, was bitten by a genetically altered spider...you can find him hanging out on the web.
Sponges - They'll soak it up.
Spyware - They're watching you.
Starbucks - "They're opening a Starbucks in my living room." - Janeane Garofalo
Steak & Eggs - The breakfast of champions...Atkins champions, anyway.
Stem Cell Research - Potential scientific breakthrough...and political hot button.
Steroids - Dude...didn't you used to have a NECK?
Steven Seagal - 1951-, American action film star of Under Siege, Executive Decision and many more. He holds the rank of 7th dan in aikido.
Substitute Teachers - "I'm a substitute Spanish teacher. Los estudiantes son mis amigos." - Peggy, King of the Hill
Sugar Daddy - "She used to have a sugar daddy and a candy-apple caddy." - Tom Waits
Super Powers - That's Incredibles!
Susan Sarandon - 1946-, American actor and social activist. Won an Academy Award for Dead Man Walking and much critical acclaim for Thelma and Louise.
Sweet Potatoes - Now available in chip form.
Swordfish - A cut above other fish.
Target Stores - Stores in 47 states... Target the one near you.
Tater Tots - "Are you gonna eat your tots?" - Napoleon Dynamite
Ted Kennedy - 1932-, U.S. Democratic Senator representing Massachusetts since 1962. One of the clan.
Teleporters - Beam me up!
The Atkins Diet - Steak and potatoes... minus the potatoes...
The Attic - It's up there somewhere...
The Axis Of Evil - The term used by President Bush to describe regimes that sponsor terror.
The Beach Boys - The band's first hit, "Surfin" came out in 1961, but beach boys have been around almost as long as California.
The Daily Show - The award-winning comedy-news program featuring Jon Stewart as anchor. And now for your moment of Zen...
The Economy - "It's the economy, stupid." - James Carville Political Strategist for Bill Clinton
The Frozen Tundra - Derived from the Finnish word for barren, a tundra has long, cold winters and strong dry winds. Muskoxen and Packer fans seem to like it.
The Hamptons - Where the elite meet to summer...
The Infantry - Branch of the army trained to fight on foot. The front line...
The Louisianna Purchase - In 1803, the U.S. purchased about 600 million acres of land from France for less than three cents per acre. Now, there's a bargain!
The Marines - The United States Marine Corps. The Few. The Proud. Semper Fi.
The Meaning Of Life - Go ask your mother.
The Milk Man - Door-to-door dairy.
The Mob - A.k.a. the Mafia. The only mob that IS organized.
The Moral Majority - A U.S. political action group founded in 1979 by Jerry Falwell to promote a conservative, fundamentalist Christian agenda.
The Pope - The spiritual leader of the Roman Catholic Church.
The Purple Heart - Awarded to members of the U.S. armed forces who are wounded or killed as a result of combat.
The Real World - In 1992, MTV launched a new genre of TV - the documentary/soap opera. Seven young people move in together and the world watches.
The Rodeo - Real cowboys... surrounded by a bunch of clowns...
The Secret Service - They're so cool, they wear sunglasses at night.
The Seven Dwarfs - From the classic 1937 Disney film, Snow White and the Seven Dwarfs. Snow White's posse.
The Speed Of Light - According to Einstein, nothing in the Universe can exceed the sped of light. It's the cosmic speed limit!
The Starship Enterprise - A galaxy-class, extended duration, starship from Star Trek. "The engines can'nae take it, Captain!"
The Suburbs - "Another Pleasant Valley Sunday, charcoal burning everywhere, rows of houses that are all the same..." - The Monkees
The Village People - Disco band formed in the 1970s. Y...M...C...A...
Thistles - The thistle has been a symbol of Scotland for over 500 years - the rest of its history is a bit thorny.
Thomas Jefferson - 1743-1826, author of the Declaration of American Independence and third president of the United States. He died on the 4th of July.
Three Bears - Is this Chicago? Then it'd be "Da Three Bears."
Toe Rings - Foot Bling.
Tony Bennett - 1926-, American singer whose music is love across generations and continents. The United Nations honored him as a ""Citizen of the World."
Tony Hawk - 1968-, American Skateboarding superhero. He led the way as skateboarding went from street sport to big business.
Tourists - Increase traffic flow ... and cash flow.
Train Depots - A hundred years later and it's an upscale restaurant and gift shop.
Trench Coat - The classic trench coat was designed by Thomas Burberry in 1901 for army officers in the U.K. It's a flashin' statement.
Trout Fishing - Everybody's got an angler.
Tsunami - The Japanese word meaning "harbor wave." The wave heightens when the speed diminishes as the wave travels into shallower water.
U.S. Air Force - U.S. air and space power. The most technologically sophisticated of the military branches. Cross Into The Blue.
Usama Bin Laden - 1957-, Saudi Arabian suspected of masterminding terrorist attacks throughout the world.
Utah - The name, Utah, came from the American Indian tribe Ute, and means "people of the mountains."
V8 - Super charged: the tomato juice or the engine. Wow, I could have had a V8!
Vegetarians - I'll take the tofu burger with the soy bacon strips.
Wall Drug - Mega-tourist stop on Interstate 90, located in Wall, South Dakota. Free Ice Water! Only 978 miles to go...
Wal-Mart - The very first Wal-Mart opened in 1962. They're now the world's largest retailer. They're on a roll...back!
Waxing - Mustache, eyebrows or the floor...it's all a pain.
Weapons - Of mass destruction, or just minor destruction.
Wedding Cake - "You may now kiss the bride..." And lovingly stuff cake into each other's face.
Weight Training - I can hardly weight.
White Castles - Square hamburgers... 24 hours a day. I'll take four "slyders" with onions!
Will Ferrell - 1967-, American television and movie actor and winner of the American Comedy Award for Saturday Night Live. Three cheers for Will!
Wine Country - A delightful Pinot Grigio...
Wisconsin - Somewhere between Illinois and Canada. Fishing, cheese, and beer. On Wisconsin!
Witness Protection Program - Get a life...a new life.
Wives - "What's for dinner, Honey?"
Wizards - "Meddle not in the affairs of wizards, for they are subtle and quick to anger." - J.J.R. Tolkien